Hh^Fp, Hh^Fp, Hh, Hh^Fp, Gs^Fms, Gs^Fms, Gs^Fms, Gs^Fms, Gs^Fms, Gs^Fms, Gs^Fms, Gs^Fms, Gs^Fms, Gs^Fms, Gs^Fms, Rr, Gg, Gs^Fds, Gs^Fds, Gs^Fms, Gs^Fms, Gs^Fms, Gs^Fms, Gs^Fms, Gs^Fms, Gs^Fms, Gs^Fms, Gs^Fms, Gs^Fms, Gs^Fms, Gs^Fms, Gs^Fms, Gs^Fms, Gs^Fms, Gs^Fms, Gs^Fms, Gs^Fms, Gs^Fms, Gs^Fms, Gs^Fms, Gs^Fms, Gs^Fms
Hh^Fp, Hh^Fp, Gs^Fp, Hh^Fms, Gs^Fms, Gs^Fms, Gll^Fp, Gll^Fp, Gs^Fms, Gs^Fms, Gs^Fms, Gll^Fp, Gll^Fp, Gs^Fds, Gs^Fms, Rr, Rr, Gs^Fms, Gs^Fds, Gs^Fms, Gs^Fms, Gs^Fms, Gs^Fms, Gg^Ve, Gs, Gs^Fms, Gll^Fp, Gll^Fp, Gs^Fms, Gs^Fms, Gs^Fp, Gs^Fms, Gs^Fms, Gs^Fms, Gs^Fms, Gs^Fms, Gs^Fms, Gs^Fms, Gs^Fms, Gs^Fms, Gs^Fms, Gs^Fms
Hh^Fp, Hh, Hh, Gs^Fp, Gs^Fms, Gs^Fms, Gll^Fp, Gs^Fds, Gs^Fms, Hh^Fds, Hh^Fms, Gs^Fms, Gs^Fms, Gll^Fp, Gll^Fp, Gs, Rr, Gs^Fds, Gs^Fms, Gs^Fms, Gs^Fms, Gs^Fms, Gs^Fms, Gs^Fms, Gs^Fms, Re^Gvs, Re^Gvs, Gg^Efm, Gg^Fet, Gs^Fms, Gs^Fms, Gs^Fms, Gs^Fms, Gs^Fms, Gs^Fms, Gs^Fms, Gg^Ve, Gs^Fms, Gs^Fms, Gs^Fms, Gs^Fms, Gs^Fms
Hh^Fp, Hh, Hh^Fp, Gs^Fms, Gs^Fms, Gll^Fp, Gs^Fms, Gs^Fms, Gs^Fms, Hh, Hh^Fp, Hh^Fds, Gs^Fms, Gs^Fms, Gll^Fp, Rr, Gg, Gs^Fms, Gs^Fms, Gll^Fp, Gll^Fp, Gs^Fds, Gs^Fms, Gs^Fds, Gs^Fms, Re^Gvs, Re^Gvs, Re^Gvs, Gg^Efm, Gs^Fms, Gs^Fms, Gs^Fms, Gg, Gs^Fds, Gs^Fds, Gs^Fds, Gg, Gg, Gs^Fms, Gs^Fms, Gs^Fms, Gs^Fms
Hh^Fp, Hh, Gs^Fms, Gs^Fms, Gll^Fp, Gs^Fms, Re, Re, Re, Hh^Fp, Hh^Fp, Hh^Fms, Gs^Fms, Gs^Fms, Rr, Rr, Gs, Gs^Fms, Gs^Fms, Gs^Fms, Gs^Fms, Gs^Em, Gs^Em, Gs^Fms, Gs^Fp, Gs^Fp, Gs^Fms, Re^Gvs, Gs, Gg, Gg^Efm, Gg, Gg, Gs^Fds, Gs^Fds, Gs^Fms, Gs^Fms, Gs^Fms, Gs^Fms, Gs^Fms, Gs^Fms, Gs^Fms
Gll^Fp, Hh^Fms, Gs^Fms, Gs^Fds, Gll^Fp, Gs^Fms, Gs^Fms, Gs^Fdw, Gs^Fms, Gs, Rr, Rr, Rr, Rr, Gg, Gs^Fms, Gs^Fms, Gs^Fms, Gs^Fms, Gs^Fds, Gs^Fms, Gs^Fms, Gs^Fms, Gs^Fp, Gs^Fms, Gs^Fms, Gg^Ve, Gs, Gs, Gg, Gg, Gg, Gg^Efm, Gg, Gs^Fms, Gs^Fms, Gs^Fms, Gg^Fet, Gs^Fms, Gs^Fms, Gs^Fms, Gs^Fms
Gll^Fp, Gll^Fp, Gs^Fds, Gs^Fms, Gll^Fp, Gll^Fp, Gs^Fms, Gs^Fms, Gs, Gs, Rr, Gs^Fms, Gs^Fms, Gs^Fms, Gs^Fds, Gs^Fms, Gs^Fds, Gs^Fds, Gll^Fp, Gs^Efm, Gs^Fms, Gs^Fms, Gs^Fms, Gs^Fds, Gs^Fms, Gs^Fms, Gs^Fms, Gg^Em, Gg^Ve, Gg, Gg, Gg^Efm, Gg, Gg^Ve, Gg, Gs^Fms, Gs^Fms, Gs^Fms, Gs^Fms, Gs^Fms, Gs^Fms, Gs^Fms
Gll^Fp, Gs^Fms, Gs^Fms, Gs^Fms, Gs^Fms, Gs^Fds, Gs^Fms, Gs^Fms, Rr, Rr, Gs^Fds, Gs^Fms, Gg^Fet, Gs^Fds, Gs^Fds, Gs^Fds, Ss, Gs^Fms, Gs^Fms, Gll^Fp, Gs^Fms, Gs^Fds, Gs^Fms, Gs^Fms, Gs^Fms, Ss, Gs^Fms, Gs^Fms, Gs^Fms, Gs^Fms, Gs^Fms, Gg, Gs, Gg^Fet, Gg, Gs^Fms, Gs^Fms, Gs^Fms, Gs^Fms, Gs^Fms, Gs^Fms, Gs^Fms
Gs^Fms, Gs^Fms, Gs^Fms, Gll^Fp, Gll^Fp, Gs^Fms, Rr, Rr, Rr, Gs^Fms, Gs^Fms, Gs^Fms, Gs^Fms, Gs^Fms, Gs^Fms, Gs^Fds, Gs^Fms, Gs^Fms, Gs^Fms, Gll^Fp, Gs^Fms, Gs^Fms, Gs^Fms, Re, Gs^Fms, Gs^Fms, Gs^Fds, Gs^Fms, Gs^Fds, Gs^Fms, Gs^Fms, Gg, Gs^Fms, Gs, Gs^Fms, Gs^Fms, Gs^Fms, Gs^Fms, Gs^Fms, Gs^Fms, Gs^Fms, Gs^Fms
Gll^Fp, Gs^Fms, Gs^Fms, Gs^Fds, Gs^Fms, Gs^Fms, Rp, Gs^Fms, Gs^Fms, Rr, Gs, Gg, Gg, Gg, Gg, Ds, Gs, Ss^Vhs, Gs^Fms, Gs^Fms, Gs^Fds, Gs^Fms, Re, Re, Gs^Fms, Gs^Fms, Gs^Fms, Gs^Fms, Gs^Fms, Gs^Fms, Gs^Fms, Gs^Fms, Gs^Fms, Gs^Fms, Gs^Fms, Gs^Fms, Gs^Fms, Gs^Fms, Gs^Fms, Gs^Fms, Gs^Fms, Gs^Fms
Gs^Fms, Gs^Fms, Gs^Fds, Gs^Fms, Gs^Fms, Rp^Ve, Rp, Gg, Gg, Rr, Rp, Gg^Efm, Gs, Gg, Re^Gvs, Gs, Gg, Gs, Gs^Fms, Gs^Fms, Gs^Fms, Gs^Fms, Gs^Fms, Gs^Fms, Gll^Fp, Gll^Fp, Gs^Fms, Gs^Fms, Gs^Fms, Gs^Fds, Gs^Fds, Gs^Fms, Gs^Fms, Gs^Fms, Gs^Fms, Gs^Fms, Gs^Fms, Gs^Fms, Gg^Ve, Gs^Fms, Gs^Fms, Gs^Fms
Gs^Fms, Gs^Fms, Gs^Fms, Gs^Fms, Gll^Fp, Gs^Fms, Rp, Gg, Gg, Rp, Rp^Ve, Rp, Re, Re, Re^Gvs, Re^Gvs, Gs, Gg, Gs, Gs^Fms, Gs^Fms, Gs^Fms, Gs^Fds, Gs^Fms, Gs^Fms, Gs^Fms, Ww, Ss, Gs^Fms, Gg, Gs^Fds, Gs^Fms, Gs^Fms, Gg^Fet, Gs^Fms, Gs^Fms, Gs^Fms, Gs^Fms, Gs^Fms, Gs^Fms, Gs^Fms, Gs^Fms
Gs^Fms, Gll^Fp, Gs^Fms, Gs^Fms, Gs^Fms, Gs^Fms, Rp, Rp, Rp, Rp, Rp, Rp, Gs^Es, Gg^Efm, Gs, Re^Gvs, Gg, Gs^Fms, Gs^Fms, Gs^Fms, Gs^Fms, Gs^Fds, Gs^Fms, Gs^Fms, Gg^Efm, Ds, Gs^Fms, Gs^Fms, Gs^Fms, Gs^Fms, Gs^Fms, Gs^Fms, Gs^Fms, Gs^Fms, Gs^Fms, Gs^Fms, Gs^Fms, Gs^Fms, Gs^Fms, Gs^Fms, Gs^Fms, Gs^Fms
Gs^Fms, Gs^Fms, Gs^Fms, Gg^Ve, Gs, Rp, Gs, Gg, Rp, Rp, Rr, Gs, Gg, Gg, Gg, Gg, Gg^Efm, Gs^Fms, Gs^Fms, Gll^Fp, Gs^Fms, Gs^Fms, Gs^Fms, Gs^Fms, Cv, Cv, Cv, Cv, Gs^Fms, Gs^Fms, Gs^Fms, Gs^Fms, Gs^Fms, Gg^Ve, Gs^Fms, Gs^Fms, Gs^Fms, Gs^Fms, Gs^Fms, Gs^Fms, Gs^Fms, Gs^Fms
Gs^Fms, Gs^Fms, Gs^Fms, Gs^Fms, Cv, Cv, Cv, Gs^Fms, Gs^Fms, Gs^Fms, Rr, Gg, Gg, Gs^Fms, Gs^Fms, Gs^Fms, Gg, Gg, Gs, Gs, Gs^Fms, Gs^Fds, Gs^Fms, Gs^Fms, Cv, 4 Kv, Cv, Gs^Fms, Gs^Fms, Gs^Fds, Gs^Fms, Gs^Fms, Gs^Fms, Gs^Fms, Gs^Fms, Gs^Fms, Gs^Fms, Gs^Fms, Gs^Fms, Gs^Fms, Gs^Fms, Gs^Fms
Gs^Fms, Gs^Fms, Gs^Fms, Cv, Cv, 3 Kv, Cv, Cv, Gs^Fms, Gg^Fet, Gs^Fms, Rr, Gg, Gs^Fds, Gs^Fms, Gs^Fms, Gs^Fms, Gs^Fms, Gs^Fms, Gs^Fms, Gs^Fms, Gs^Fms, Gs^Fms, Cv, Gs^Fms, Cv, Gs^Fms, Gs^Fms, Gs^Fms, Gs^Fds, Gs^Fms, Gs^Fms, Gs^Fms, Gs^Fms, Gs^Fms, Gs^Fms, Gs^Fms, Gg^Ve, Gs^Fms, Gs^Fms, Gs^Fms, Gs^Fms
Gs^Fms, Gs^Fms, Rp^Ve, Gs^Fds, Cv, Cv, Cv, Gs^Fds, Gll^Fp, Gs^Fms, Gs^Fds, Rr, Gg^Es, Gs^Fms, Gs^Fms, Gs^Fds, Gll^Fp, Gs^Fms, Gs^Fds, Gs^Fms, Gs^Fms, Gs^Fds, Gs^Fms, Gs^Fms, Gs^Fms, Gs^Fms, Gs^Fms, Gs^Fms, Gll^Fp, Gs^Fms, Gs^Fms, Gs^Fms, Gs^Fms, Gs^Fms, Gs^Fms, Gs^Fms, Gg, Gg, Gg, Gs^Fms, Gs^Fms, Gs^Fms
Gs^Fds, Gs^Fds, Gs^Fds, Rp, Gs^Fms, Gs^Fms, Gll^Fp, Gs^Fms, Gll^Fp, Gs^Fds, Rr, Rr, Gg, Gs, Gs^Fms, Gs^Fms, Gs^Fms, Gll^Fp, Gs^Fms, Gs^Fms, Gll^Fp, Gll^Fp, Gll^Fp, Gs^Fms, Gs^Fds, Gg^Ve, Gs^Fms, Gll^Fp, Gs, Gll^Fp, Gs^Fms, Gs^Fms, Gs^Fms, Gs^Fms, Ce, Ce, Ce, Gg, Gs^Fms, Gs^Fms, Gs^Fms, Gs^Fms
Ww, Ww, Ww, Rr, Gs^Fds, Gs^Fms, Gs^Fms, Gll^Fp, Gs^Fms, Gs^Fms, Rr, Gg, Gg^Efm, Gs^Fms, Gs^Fds, Gg^Ve, Gs^Fms, Gs^Fms, Gs^Fms, Gs^Fms, Gs^Fms, Gs^Fms, Gs^Fms, Gs^Fms, Gs^Fms, Gs^Fms, Gs^Fms, Gll^Fp, Gll^Fp, Gll^Fp, Gs^Fms, Gs^Fms, Gs^Fms, Gs^Fms, Ce, 1 Ke, Ce, Gs^Fms, Gs^Fms, Gs^Fms, Gs^Fms, Gs^Fms
Gs^Fds, Gs^Fds, Gs^Fds, Ww^Bsb|, Wwf, Gs^Fds, Hh^Fds, Gs^Fds, Gs^Fds, Gs^Fms, Rr, Gg^Es, Hh^Fds, Gs^Fms, Wwf, Gs^Fms, Gs^Fds, Ds, Ds, Gg, Gs, Gs^Fds, Gs^Fds, Gs^Fds, Gs^Fds, Gs^Fms, Gs^Fms, Gs^Fms, Gs^Fms, Gs^Fms, Re, Gs^Fms, Gs^Fms, Gs^Fms, Re, Ce, Re, Gs^Fms, Gs^Fms, Gs^Fms, Gs^Fms, Gs^Fms
Gs^Fms, Gs^Fms, Gs^Fms, Rr, Rr, Wwf, Wwf, Wwf, Wwf, Gs^Fds, Wwf^Bw|, Gs^Fds, Wwf, Wwf, Gs^Fds, Wwf, Ww, Ww^Ewl, Ww, Gs^Fds, Ss, Ss, Ss, Ss, Wwf, Gs^Fds, Wwf, Gs^Fds, Re, Re, Gs^Fds, Re, Re, Re, Gs^Fms, Re, Gs^Fms, Re, Re, Re, Re, Gs^Fms
Gs^Fms, Gs^Fms, Gs^Fms, Gs^Fms, Rr, Gs^Fds, Gs^Fds, Gs^Fds, Gs^Fds, Wwf, Gs^Fds, Wwf, Gs^Fds, Gs^Fms, Gs^Fms, Gs^Fds, Ww, Ww, Ww, Ww, Wwf, Wwf, Wwf, Wwf, Hh, Wwf, Re, Wwf^Bsb/, Wwf, Gs^Fds, Wwf, Gs^Fds, Gs^Fms, Gs^Fms, Gs^Fms, Gs^Fms, Gs^Fms, Gs^Fms, Gs^Fms, Gs^Fms, Gs^Fms, Re
Gs^Fms, Gs^Fds, Gs^Fms, Gs^Fms, Rr, Gs^Fms, Gs^Fms, Gs^Fms, Gs^Fms, Gs^Fds, Gs^Fms, Gs^Fms, Gs^Fms, Gs^Fms, Gs^Fms, Gg^Fet, Ww, Wwr, Ww, Ww, Re, Ss, Ss, Ss, Gs^Fds, Gs^Fds, Re, Gs^Fms, Gs^Fds, Wwf, Gs^Fms, Wwf, Wwf, Gs^Fms, Gs^Fms, Gs^Fms, Gg^Fet, Gs^Fms, Gs^Fms, Gs^Fms, Gs^Fms, Gs^Fms
Gs^Fms, Gs^Fms, Gs^Fms, Gs^Fds, Rr, Gs^Fms, Gs^Fp, Gs^Fms, Gs^Fms, Gs^Fms, Gs^Fds, Gs^Fds, Gs^Fms, Gs^Fms, Gs^Fms, Ds, Ww, Ww, Ww, Gs^Fds, Gs^Fms, Gs^Fds, Gs^Fds, Hh, Hh^Fp, Gs^Fms, Re, Gg^Fet, Gs^Fms, Gs^Fds, Gs^Fms, Gs^Fds, Gs^Fms, Wwf, Wwt, Ww^Ewl, Wwt, Gs^Fms, Wwt, Gs^Fms, Ww^Ewl, Gs^Fms
Gs^Fp, Gs^Fp, Gs^Fms, Rr, Hh^Fms, Gs^Fms, Hh^Fp, Hh^Fp, Gs^Fms, Gs^Fms, Gs^Fms, Gs^Fds, Gs^Fms, Gg^Efm, Gs^Fms, Gs^Fds, Gs^Fds, Gs^Fds, Gs^Fds, Gs^Fds, Gs^Fms, Gs^Fms, Ww, Gs^Fms, Gll^Fp, Gs^Fms, Re, Gs^Fms, Gs^Fms, Gs^Fms, Gs^Fms, Gs^Fms, Gs^Fms, Gs^Fms, Gs^Fms, Gs^Fms, Gs^Fms, Wwt, Gs^Fms, Wwt, Gs^Fms, Wwt
Gs^Fms, Gs^Fms, Gs^Fms, Rr, Hh^Fms, Hh^Fms, Rr, Gs^Fms, Rp^Ve, Gs^Fms, Gs^Fms, Gll^Fp, Gll^Fp, Gs^Fms, Gs^Fms, Gs^Fms, Gs^Fms, Gs^Fms, Gs^Fms, Gs^Fms, Gs^Fms, Gs^Fms, Gs^Fms, Gs^Fds, Gs^Fms, Gs^Fms, Rp, Gll^Fp, Gs^Fms, Gs^Fds, Gs^Fms, Gs^Fms, Gs^Fms, Gs^Fms, Gs^Fms, Gs^Fms, Gs^Fms, Gs^Fms, Gs^Fms, Gs^Fms, Gs^Fms, Gs^Fms
Gs^Fms, Gs^Fp, Gs^Fms, Rr, Rr, Rr, Gs^Fms, Rp, Rp, Gs^Fms, Gs^Fms, Gll^Fp, Gs^Fms, Gs^Fms, Rp^Ve, Gs^Fms, Gs^Fms, Gll^Fp, Gs^Fms, Gs^Fds, Gll^Fp, Gs^Em, Gs^Fms, Gll^Fp, Gs^Fms, Rp^Ve, Rp, Gs^Fms, Gs^Fds, Gll^Fp, Gll^Fp, Gs^Fms, Gg^Ve, Gs^Fms, Gs^Fms, Gs^Fms, Gs^Fms, Gs^Fms, Gs^Fms, Gs^Fms, Gs^Fms, Gs^Fms
Gs^Fms, Gs^Fms, Gs^Fms, Gg^Fet, Gs^Fms, Gs^Fms, Gs^Fms, Gs^Fms, Rr, Gs^Fms, Gs^Fms, Gll^Fp, Gs^Fms, Gs^Fms, Gs^Fms, Rp, Rr, Gs^Fms, Gs^Fms, Gs^Fms, Gll^Fp, Gs^Fms, Gs^Fms, Gs^Fms, Rr, Rp, Gs^Fms, Gs^Fms, Gs^Fms, Gs^Fms, Hh^Fds, Gs^Fms, Gs^Fms, Gs^Fms, Gs^Fms, Gs^Fms, Gs^Fms, Gs^Fms, Gs^Fms, Gs^Fms, Gs^Fms, Gs^Fms
Gs^Fms, Gll^Fp, Gs^Fms, Gs^Fms, Gll^Fp, Gs^Fms, Gs^Fds, Gs^Fds, Gs^Fds, Rr, Rr, Rr, Ce, Rr, Rr, Rr, Gs^Fms, Rr, Rr, Gs^Fms, Gs^Fms, Gs^Fds, Rr, Rr, Gs^Fms, Gll^Fp, Gs^Fms, Gs^Fms, Hh, Gs^Fms, Hh, Hh^Fp, Gs^Fms, Gs^Fms, Gs^Fms, Gs^Fms, Gs^Fms, Gs^Fms, Gs^Fms, Gs^Fms, Gs^Fms, Gs^Fms
Gs^Fms, Gs^Fms, Gs^Fds, Gs^Em, Gs^Fms, Gs^Fms, Gs^Fms, Gs^Fds, Gs^Fds, Gg, Rd, Ce, 2 Ke, Ce, Gs^Fms, Gs^Fds, Gs^Fds, Gs^Fms, Gll^Fp, Rr, Rr, Rr, Gll^Fp, Gs^Fms, Gs^Fms, Gs^Fms, Hh^Fds, Gs^Fms, Hh, Hh^Fp, Hh, Hh^Fp, Gs^Fms, Gs^Fms, Gs^Fms, Gs^Fms, Gs^Fms, Gg^Ve, Gs^Fms, Gs^Fms, Gs^Fms, Gs^Fms
Gll^Fp, Gll^Fp, Gll^Fp, Gs^Fms, Gs^Fms, Gs^Fms, Gg, Gs^Fms, Gg, Rd, Gs^Fms, Ce, Gll^Fp, Gs^Fms, Gll^Fp, Gs^Fds, Gll^Fp, Gs^Fms, Gs^Fms, Gs^Fms, Gs^Fms, Gs^Fms, Gs^Fms, Gll^Fp, Hh^Fds, Hh^Fp, Hh, Hh^Fp, Hh, Hh^Fp, Hh^Fp, Hh^Fp, Gs^Fms, Gs^Fms, Gs^Fms, Gs^Fms, Gs^Fms, Gs^Fms, Gs^Fms, Gs^Fms, Gs^Fms, Gs^Fms
Gll^Fp, Gll^Fp, Gll^Fp, Gs^Fms, Gs^Fms, Gs^Fms, Gs^Fms, Gs^Fms, Gs^Fms, Rd, Gs^Fms, Gs^Fms, Gs^Fms, Gll^Fp, Gs^Fds, Gll^Fp, Gs^Fms, Gs^Fds, Gs^Fms, Gs^Fms, Gs^Fms, Gs^Fms, Gs^Fms, Gs^Fms, Gs^Fms, Hh, Gs^Fp, Hh, Gs^Fp, Hh, Hh^Fp, Hh^Fp, Gs^Fms, Gs^Fms, Gs^Fms, Gs^Fms, Gs^Fms, Gs^Fms, Gs^Fms, Gs^Fms, Gs^Fms, Gs^Fms
