Ms, Ms, Ms, Ms, Ms, Ms, Ms, Ms, Ms, Ms, Ms, Ms, Ms, Ms, Ms, Ms, Ms, Aa, Xoa, Xoa, Xoa, Xoa, Xoa, Xoa, Xoa, Xoa, Xoa, Xoa, Xoa, Xoa, Xoa, Xoa, Aa, Aa^Fpa, Aa^Fpa, Aa^Fpa, Aa^Fpa, Aa^Fpa, Aa^Fpa, Aa^Fpa, Ms, Ms, Ms, Ms, Ms, Ms, Ms, Aa^Fpa, Ms, Ms, Ms, Aa^Fpa, Ms, Ms, Ms, Aa^Fpa, Ms, Aa^Fpa
Ms, Ms, Ms, Ms, Ms, Ms, Ms, Ms, Ms, Ms, Ms, Ms, Ms, Ms, Ms, Ms, Ms, Aa, Xoa, Xoa, Xoa, Xoa, Xoa, Xoa, Xoa, Xoa, Xoa, Xoa, Iwo, Xoa, Xoa, Xoa, Xoa, Aa, Aa, Aa^Fpa, Aa^Fpa, Aa^Fpa, Aa^Vaa, Aa^Fpa, Ms, Ms, Ms, Ms, Ms, Ms, Ms, Ms, Ms, Ms, Ms, Ms, Ms, Ms, Ms, Ms, Ms, Ms
Ms, Ms, Ms, Ms, Ms, Ms, Ms, Ms, Ms, Ms, Ms, Ms, Ms, Ms, Ms, Ms, Ms, Ms, Xoa, Xoa, Exos, Xoa, Xoa, Xoa, Xoa, Xoa, Isa, Iwo, Urc, Iwo, Isa, Xoa, Xoa, Xoa, Aa, Aa^Fpa, Aa^Fpa, Aa^Fpa, Aa^Vaa, Aa, Aa, Ms, Ms, Ms, Ms, Ms, Ms, Ms, Ms, Ms, Ms, Ms, Ms, Ms, Ms, Ms, Ms, Ms
Ms, Ms, Ms, Ms, Ms, Ms, Ms, Ms, Ms, Ms, Ms, Ms, Ms, Ms, Ms, Ms, Ms, Xoa, Xoa, Exos, Aa, Urc, Urb, Exos, Exos, Exos, Isa, Urc, Urc, Urc, Xoa, Xoa, Urc, Xoa, Aa^Dr, Aa, Aa, Aa^Fpa, Aa^Fpa, Aa, Aa^Fpa, Aa^Fpa, Aa^Vaa, Aa^Fpa, Aa, Aa, Aa^Fpa, Aa^Fpa, Aa^Fpa, Ms, Ms, Ms, Ms, Ms, Ms, Ms, Ms, Ms
Ms, Ms, Ms, Ms, Ms, Ms, Ms, Ms, Ms^Xm, Ms^Xm, Ms^Xm, Ms^Xm, Ms^Xm, Ms, Ms, Ms, Ms, Ha, Ha, Aa^Dr, Aa, Aa, Urb, Xoa, Xoa, Xoa, Xoa, Iwo, Isa, Xoa, Urc, Urc, Urc, Urc, Xoa, Xoa, Aa, Aa^Fpa, Aa, Aa^Fpa, Aa^Feta, Aa^Fpa, Aa^Fpa, Aa, Aa, Aa, Aa^Fpa, Aa^Fpa, Aa^Fpa, Aa, Ms, Ms, Ms, Ms, Ms, Ms, Ms, Ms
Ms, Ms, Ms, Ms, Ms, Ms, Ms, Ms^Xm, Ms^Xm, Ms^Xm, Ms^Xm, Ms^Xm, Ms^Xm, Ms, Ms, Ms, Ha, Ha, Ha, Aa^Dr, Aa, Xoa, Xoa, Xoa, Xoa, Xoa, Xoa, Xoa, Iwo, Iwo, Iwo, Urc, Xoa, Xoa, Xoa, Xoa, Xoa, Aa, Aa, Aa, Aa^Fpa, Aa^Fpa, Aa^Fpa, Aa^Fpa, Aa^Fpa, Aa^Fpa, Aa^Feta, Aa^Fpa, Aa, Aa, Aa, Ms, Aa, Ms, Ms, Ms, Ms, Ms
Ms, Ms, Ms, Ms, Ms, Ms, Ms, Ms, Ms, Ms^Xm, Ms^Xm, Ms^Xm, Ms, Ms, Ms, Ms, Ha, Ha, Xoa, Xoa, Exos, Xoa, Xoa, Xoa, Xoi, Xoi, Xoa, Chr, Iwo, Isa, Isa, Isr, Xoa, Xoa, Xoa, Xoa, Rr, Xoa, Xoa, Aa, Aa, Aa, Aa, Aa^Fpa, Aa^Fpa, Aa^Fpa, Aa, Aa, Ha, Aa, Ha, Ha, Aa, Aa, Aa^Fpa, Ms, Ms, Ms
Ms, Ms, Ms, Ms, Ms^Xm, Ms, Ms, Ms, Ms, Ms^Xm, Ms, Ms^Xm, Ms, Ms, Xoa, Ms, Xoa, Xoa, Xoa, Xoa, Urb, Ur, Urb, Xoa, Xoa, Xoa, Isa, Isa, Isa, Chr, Isa, Isa^Edb, Xoa, Xoa, Rr, Rr, Isa^Ii, Rr, Rr, Xoa, Xoa, Aa, Aa, Aa, Aa, Aa^Fpa, Aa, Ha, Ha, Aa, Aa, Aa, Aa^Fpa, Aa^Fpa, Aa^Fpa, Ha^Fpa, Aa, Aa
Ms, Ms, Ms^Xm, Ms^Xm, Ms^Xm, Ms^Xm, Ms, Ms, Ms, Ms, Ms, Ms, Ms, Xoa, Xoa, Xoa, Xoa, Xoa, Urb, Urb, Urb, Ur, Chr, Urb, Isa, Isa, Isa, Isa, Isa, Isa, Isa, Chr, Xoa, Rr, Isa, Isa^Dr, Isa, Isa, Rr, Rr, Xoa, Xoa, Xoa, Aa, Aa, Aa, Aa, Aa, Ha, Aa, Ha, Aa, Aa^Fpa, Aa^Fpa, Aa^Fpa, Aa^Vka, Aa, Aa
Ms, Ms^Xm, Ms^Xm, Ms^Xm, Ms^Xm, Ms, Ms, Ms, 3 Ms, Ms, Ms, Ms, Xoa, Xoa, Xoa, Xoa, Ur, Urb, Urb, Ur, Urb, Urb, Xoa, Urb, Isa, Isa, Xoa, Xoa, Xoa, Uu, Isa^Edt, Isa, Isa, Xoa, Isa, Isa, Rr, Rr, Xoa, Xoa, Rr, Rr, Isa, Xoa, Xoa, Aa, Aa, Aa, Aa, Ha, Aa^Vka, Aa, Aa, Aa^Fpa, Aa^Fpa, Aa, Ha, Ha
Ms, Ms^Xm, Ms^Xm, Ms^Xm, Ms, Ms, Ms, Ms, Ms, Ms, Xoa, Xoa, Xoa, Xoa, Xoa, Xoa, Chr, Ur, Urb, Urb, Urb, Xoa, Isa, Isa, Isa, Xoa, Chr, 2 Khr, Chr, Xoa, Xoa, Isa, Isa, Isa, Isa, Xoa, Xoa, Xoa, Rr, Rr, Isa, Isa^Ii, Isa, Isa, Rr, Xoa, Aa, Aa^Feta, Aa, Aa, Aa, Aa, Ha, Aa, Aa, Aa, Ha, Ha
Ms, Ms^Xm, Ms, Ms, Ms, Ms, Ms, Ms, Xoa, Xoa, Xoa, Xoa, Xoa, Xoa, Xoa, Xoa, Urb, Urb, Chr, Xoa, Isa, Xoa, Isa, Isa, Rp, Xoa, Xoa, Chr, Chr, Chr, Urb^Edt, Urb, Xoa, Isa, Isa, Isa, Isa^Edt, Xoa, Xoa, Isa, Isa, Isa^Ii, Aa, Aa, Xoa, Xoa, Aa, Aa, Ha, Aa, Aa, Ha, Aa, Aa, Ha, Ha, Ha, Ha
Ms, Ms, Ms, Ms, Ms, Ms, Ms, Ms, Xoa, Xoa, Xoa, Xoa, Xoa, Xoa, Isa, Isa^Dr, Urc, Xoa, Xoa, Isa, Xoa, Xoa, Isa, Isa, Rp, Rp, Rp^Dr, Rp, Rp, Xoa, Exos, Urb, Exos, Xoa, Xoa, Isa, Isa^Edb, Isa^Edt, Isa^Edb, Isa, Xoa, Rr, Xoa, Ha, Aa, Aa, Aa, Ha, Ha, Ha, Aa, Ha, Ha, Ha, Aa, Ha, Ha, Ha
Ms, Ms, Ms, Ms, Ms, Ms, Ms, Xoa, Xoa, Xoa, Xoa, Xoa, Isa, Isa, Isa, Isa, Urc, Urc, Urc, Xoa, Urb, Urb, Isa, Rp, Isa, Rp, Xoa, Rp, Rp, Isa, Isa^Dr, Xoa, Xoa, Exos, Exos, Xoa, Xoa, Isa, Aa, Aa, Aa, Xoa, Aa, Aa, Aa, Aa, Aa^Voa, Aa, Aa, Ha, Ha, Ha, Ha, Aa, Aa, Ha, Ha, Ha
Ms, Ms, Ms, Ms, Ms, Ms, Ms, Xoa, Xoa, Xoi, Xoa, Isa, Urc, Isa, Urc, Urc, Urc, Urc, Xoa, Urb, Urb, Urb, Urb, Urb, Xoa, Isa, Isa^Edt, Xoa, Xoa, Isa^Dr, Rrd, Isa, Rr, Exos, Exos, Xoa, Xoa, Exos, Exos, Aa, Aa, Aa^Dr, Aa, Exos, Aa, Aa, Aa, Aa, Aa, Aa, Ha^Fpa, Ha^Fpa, Ha, Aa, Aa, Aa, Aa, Ha
Ms, Ms, Ms, Ms, Ms, Ms, Ms, Xoa, Xoa, Xoi, Xoa, Xoa, Urc, Urc, Urc, Urc, Exos, Xoa, Urb^Edt, Urb, Urb, Urb, Xoa, Xoa, Uu, Xoa, Xoa, Isa^Edt, Xoa, Xoa, Xoa, Rrd, Rrd^Dr, Rp^Dr, Rp, Xoa, Exos, Aa, Aa, Aa^Dr, Aa^Dr, Aa, Exos, Exos, Ha, Aa, Ha, Aa, Aa, Aa, Aa^Fpa, Ha^Fpa, Aa^Fpa, Aa^Fpa, Aa, Aa^Vka, Ha, Ha
Ms, Ms, Ms, Ms, Ms, Ms, Ms, Xoa, Xoa, Xoa, Xoa, Xoa, Xoa, Urc, Urc, Xoa, Urb, Urb, Urb, Urb, Xoa, Xoa, Uu, Uu, Xoa, Uu^Qhh, Xoa, Uu, Uu, Isa, Isa, Xoa, Isa, Rrd, Rrd, Aa, Aa, Aa, Aa, Exos, Aa, Aa, Aa, Ha, Ha, Ha, Ha, Aa, Aa, Aa, Aa, Aa, Ha, Ha, Ha, Ha, Ha, Ha
Ms, Ms, Ms, Ms, Ms, Ms, Ms, Ms, Xoa, Xoa, Xoa, Xoa, Xoa^Efs, Xoa, Urb, Uu, Urb, Urb^Edt, Xoa, Xoa, Uu^Vu, Xoa, Xoa, Ur, Ur^Edb, Xoa, Uu, Uu, Uu, Xoa, Xoa, Exos, Urc, Urc, Rd, Aa, Aa, Aa, Ai^Qhu, Aa, Aa, Aa, Aa, Ha, Ha, Ha, Aa, Aa, Aa, Aa, Ha, Aa, Ha, Ha^Vka, Ha, Ha, Ha, Ha
Ms, Ms, Ms, Ms, Ms, Ms, Ms, Ms, Ms, Xoa, Xoa, Xoa, Xoa, Urb, Urb^Edb, Urb, Urb, Xoa, Xoa, Uu^Qhh, Uu^Qhh, Ur, Xoa, Xoa, Ur^Ii, Rp, Uu^Qhu, Xoa, Xoa, Exos, Tb^Tfi, Xoa, Xoa, Urc, Rr^Dr, Rr^Dr, Rrd, Ce, 1 Ke, Re, Rrd, Aa, Ha, Ha, Ha, Ha, Ha, Aa, Ha, Ha, Ha, Ha, Ha, Ha, Ha, Ha, Ha, Ha
Ms, Ms, Ms, Ms, Ms, Ms, Ms, Ms, Ms, Ms, Ms, Xoa, Xoa, Xoa, Xoa, Urb, Urb, Urb, Urb, Xoa^Efs, Xoa, Ur^Ii, Ur^Dr, Ur^Edb, Ur^Dr, Xoa, Xoa, Uu^Qhu, Xoa, Uu, Uu, Uu^Qhu, Xoa, Xoa, Re, Ur^Ii, Ur, Ce, Ce, Rrd, Re^Vct, Re, Ha, Ha, Ha, Ha, Ha, Ha, Aa, Ha, Aa, Aa, Ha, Ha, Ha^Qhh, Ha, Ha^Esa, Ha^Qhh
Ms, Ms, Ms, Ms, Ms, Ms, Ms, Ms, Ms, Ms, Ms, Ms, Ms, Xoa, Xoa, Xoa, Xoa, Urb, Urb, Urb, Urb, Exos, Ur, Ur^Edt, Ur, Ur, Xoa, Urb, Urb, Urb, Xoa, Xoa, Xoa, Re, Aa, Aa, Re, Ur^Ii, Re^Vct, Ce, Rrd, Re, Re, Aa, Aa, Ha, Aa, Ha, Aa, Aa, Aa, Aa, Ha^Qhh, Ha^Qhh, Ha^Qhh, Ha, Ha^Fdw, Ha^Fdw
Ms, Ms, Ms^Xm, Ms^Xm, Ms^Xm, Ms, Ms, Ms, Ms, Ms, Ms, Ms, Ms, Xoa, Ha^Dr, Xoa, Ha^Dr, Xoa, Chr, Urb, Xor, Urb^Edt, Urb, Xoa^Efs, Xoa, Xoa, Urb, Urb, Urb, Uu^Vu, Xoa, Xoa, Xoa, Xoa, Xoa, Re, Re, Ai^Qhu, Ai^Qhu, Ur, Aa, Re, Re, Aa, Aa, Aa, Aa, Aa, Ha^Dr, Aa, Aa, Ha^Qhh, Aa, Aa, Aa, Aa, Aa^Fdw, Aa^Fda
Ms, Ms, Ms, Ms^Xm, Ms^Xm, Ms, Ms, Ms, Ms, Ms, Ms, Ms, Ms, Ms, Ha, Ha^Dr, Xoa, Xoa, Urb, Urb, Xor, Xor, Xoa, Urb, Urb^Ii, Urb, Xoa, Xoa, Xoa, Urb, Urb, Xoa, Xoa, Xoa, Xoa, Xoa, Xoa, Aa, Re, Xoa, Xoa, Aa, Aa, Aa, Aa^Voa, Aa, Aa, Aa^Dr, Aa, Aa^Esa, Aa, Aa, Aa, Aa, Aa, Aa, Aa^Fda, Aa^Fda
Ms, Ms, Ms, Ms^Xm, Ms^Xm, Ms, Ms, Ms, Ms, Ms, Ms, Ha, Aa^Dr, Ha, Ha^Dr, Ha, Ha, Xoa, Urb, Urb, Xoa, Xoa, Urb^Dr, Xoa, Urb, Urb, Xoa, Xoa, Xoa, Xoa, Urb, Urb, Xoa, Xoa, Xoa, Xoa, Xoa, Xoa, Re, Xoa, Ur, Ur^Dr, Ha, Aa^Eb, Aa, Re, Aa, Aa, Aa, Aa, Aa, Aa^Vka, Aa, Aa, Aa, Aa, Aa, Aa^Fda
Ms, Ms, Ms, Ms^Xm, Ms^Xm, Ms, Ms, Ms, Ms, Ms, Aa, Aa, Aa, Aa, Aa, Aa, Aa, Aa, Xoa, Xoa, Xoa, Xoa, Urb, Urb, Urb, Chr, Xoa, Xoa, Urb, Urb, Xoa, Urb^Dr, Isa, Isa, Xoa, Xoa, Ha, Ha, Ha, Rb^Vo, Re, Rb, Chr, Ha, Aa, Re, Aa, Aa, Aa, Aa, Aa, Aa, Aa, Aa, Aa, Ha^Esa, Aa, Aa
Ms, Ms, Ms, Ms^Xm, Ms, Ms, Ms, Ms, Ms, Ms, Aa^Dr, Aa, Aa, Aa, Aa, Aa, Aa, Aa, Aa, Xoa, Xoi, Xoa, Xoa, Urb, Xoa, Xoa, Urb, Urb, Xoa, Xoa, Xoa, Isa, Isa, Isa, Exos, Xoa, Ha, Ha, Ha, Aa, Chr, Aa, Aa^Dr, Aa, Aa, Aa, Aa, Rb, Rb, Aa, Aa, Aa, Aa, Aa, Aa^Esa, Aa, Ha, Ha
Ms, Ms, Ms, Ms, Ms, Ms, Ms, Ms, Ms, Ms, Aa^Dr, Aa, Aa, Aa, Aa, Aa, Aa, Aa, Aa, Xoa, Xoi, Xoa, Xoa, Xoa, Urb, Urb, Urb, Urb^Dr, Isa, Xoa, Xoa, Xoa, Xoa, Xoa, Ha, Ha, Ha, Ha, Ha, Ha, Aa^Esa, Aa, Aa, Aa, Aa, Aa, Aa, Aa, Aa, Rb, Aa, Rb, Aa, Aa, Aa, Ha, Aa, Aa
Ms, Ms, Ms^Xm, Ms, Ms, Ms, Ms, Ms, Ms, Aa, Aa^Dr, Aa^Dr, Aa, Ai, Ai, Aa, Ai, Aa, Aa, Xoa, Xoa, Xoa, Urb, Urb, Xoa, Xoa, Isa, Isa^Dr, Isa, Isa, Xoa^Dr, Xoa, Xoa, Xoa, Ha, Ha, Ha, Ha, Ha^Qhh, Ha^Qhh, Aa, Aa, Aa, Aa, Aa^Voa, Aa, Aa, Aa, Aa, Aa, Aa, Rb, Aa, Aa, Aa, Aa, Aa, Ha^Esa
Ms^Xm, Ms, Ms^Xm, Ms, Ms, Ms, Ms, Ms, Ms, Aa, Ms, Aa^Dr, Aa, Ai, Ai, Ai, Ai, Aa, Aa, Xoa, Aa, Urb, Urb^Dr, Xoa, Isa, Xoa, Xoa, Isa, Xoa, Aa^Dr, Ha, Xoa, Ha, Ha, Ha, Ha, Ha^Fma, Ha^Qhh, Aa, Aa, Aa^Fdw, Aa, Aa, Aa, Aa, Aa, Aa, Aa, Aa, Rb, Rb, Aa, Aa, Aa^Vka, Aa, Aa^Esa, Ha, Ha
Ms, Ms^Xm, Ms^Xm, Ms^Xm, Ms^Xm, Ms, Ms, Ms, Ms, Ms, Ms, Ha, Ha, Ai, Ha, Ai, Ha, Aa, Aa, Aa, Isa^Dr, Xoa, Xoa, Isa, Isa, Isa, Xoa, Xoa, Ha, Ha, Ha, Ha, Ha, Ha, Ha^Qhh, Ha, Ha^Fma, Aa, Aa^Vka, Aa, Aa^Fda, Aa^Fda, Aa^Fda, Aa^Fda, Aa^Fdw, Aa, Aa^Fda, Aa, Aa, Aa, Rb, Aa, Aa, Aa, Ai^Qhu, Aa^Esa, Aa, Ha
Ms, Ms, Ms, Ms^Xm, Ms, Ms, Ms, Ms, Ms, Ms, Ms, Ha, Ms, Ha, Ms, Ha, Urb^Dr, Aa, Ms, Isa^Dr, Aa, Aa, Xoa, Xoa, Xoa, Xoa, Xoa, Xoa, Ha, Ha, Ha, Ha, Ha^Qhh, Ha^Qhh, Ha^Esa, Ha^Fma, Aa, Aa^Fma, Aa^Fda, Aa, Aa^Fma, Aa^Fma, Aa, Aa^Fda, Aa^Fda, Aa^Esa, Aa^Fda, Aa, Aa, Rb, Rb, Aa, Aa, Ai^Qhu, Ai^Qhu, Ai^Qhu, Ai^Qhu, Ha
Ms, Ms, Ms, Ms, Ms, Ms, Ms, Ms, Ms, Ms, Ms, Ms, Ms, Ms, Ms, Ms, Ms, Ms, Ms, Ms, Ms, Isa^Dr, Xoa, Xoa, Xoa, Xoa, Qxu, Ha, Ha, Ha, Ha^Qhh, Ha^Qhh, Ha^Qhh, Ha, Ha^Qhh, Ha, Ha, Aa^Fma, Ha, Aa^Fda, Aa^Fda, Aa^Fma, Aa, Aa^Fda, Aa, Aa^Fda, Aa^Fda, Aa^Fda, Aa, Aa, Rb, Aa, Ai, Ai^Qhu, Ai^Qhu, Ai^Qhu, Ai^Qhu, Ai^Qhu
