Ha, Ha, Ha, Ha^Fda, Ha^Fda, Ha, Ha^Fma, Hh, Aa^Fda, Ai, Ai, Ww, Rra, Aa, Aa, Aa^Fda, Ha^Fma, Ha, Ha^Fda, Hh, Ha^Fda, Hh, Ms, Mm, Ms, Mm, Ms, Mm, Ms, Mm, Ms, Ms, Ms, Ms, Ms, Ms, Ms, Ms, Ms, Ms, Ms, Ms, Ms, Mm, Ms, Ms, Ms
Ha^Fpa, Ha^Fpa, Ha^Fda, Ha, Ha, Ha, Ha^Fma, Aa^Fma, Aa^Fda, Ai, Ww, Wwg, Rra, Aa^Fda, Ai, Aa^Fma, Aa^Fda, Ha, Ha^Fda, Ha^Fpa, Ha^Fpa, Ha, Ha, Ms, Ms, Ms, Ms, Ms, Ms, Ms, Ms, Ms, Ms, Ms, Ms, Ms, Ms, Ms, Ms, Ms, Ms, Ms, Ms, Ms, Ms, Ms, Ms
Ha^Fda, Ha^Fpa, Ha^Fda, Ha^Fda, Ha^Fda, Ha^Fma, Aa^Fma, Aa^Fma, Aa^Fma, Ai, Ai, Wwg, Wwg, Rra, Ai, Aa, Aa^Fpa, Aa^Fpa, Ha^Fda, Ha^Fpa, Ha, Ha, Ha, Ms, Ms, Ms, Ms, Ms, Ms, Ms, Ms, Ms, Ms, Ms, Ms, Ms, Cfa, Ms, Ms, Ms, Ms, Ms, Ms, Ms, Ms, Ms, Ms
Ha, Ha, Ha, Ha^Fma, Ha^Fma, Aa^Feta, Aa^Fma, Aa^Fpa, Aa^Fda, Aa^Fpa, Aa, Wwf, Wwf, Ww^Bsa|, Ai, Ai, Aa, Aa, Aa^Fpa, Ha, Ha, Ha^Fma, Ha^Fma, Ms, Ms, Ms, Ms, Ms, Ms, Ms, Ms, Ms, Ms, Ms, Ha, Cfa, 2 Kfa, Cfa, Ha, Ms, Ms, Ms, Ms, Ms, Ms, Ms, Ms
Ha^Fpa, Ha^Fpa, Ha, Ha^Fpa, Aa, Aa^Fma, Aa, Aa, Aa^Fda, Aa^Fda, Aa, Aa, Ww, Rra, Ai, Ai, Aa^Fpa, Ha^Fma, Aa^Fpa, Aa, Ha^Fda, Ha^Fda, Ha, Ha^Fda, Ms, Ms, Ms, Ms, Ms, Ms, Ms, Ms, Ms, Ha, Rr, Cfa, Rr, Cfa, Rr, Ha, Ms, Ms, Ms, Ms, Ms, Ms, Ms
Ha, Ha^Fda, Ha, Ha^Fpa, Aa, Aa^Fda, Aa, Aa^Fpa, Aa, Aa^Vaa, Aa, Wwf, Wwf, Rra, Rra, Aa, Ha^Fda, Ha^Fda, Hh^Fma, Aa, Aa, Ha, Ha, Ha, Ha, Ms, Ms, Ms, Ms, Ms, Ms, Ms, Ms, Ha, Rr, Rr, Ha, Rr, Ha, Rr, Rr, Ms, Ms, Ms, Ms, Ms, Ms
Ha^Fpa, Ha, Aa^Fpa, Aa^Fpa, Aa^Fpa, Aa, Aa, Aa, Aa, Aa, Aa, Aa^Fpa, Wwf, Wwg, Rp, Aa, Aa, Gd^Fdw, Gd, Gd^Fdw, Gd, Aa, Gd, Ha, Ha, Ms, Ms, Ms, Ms, Ms, Ms, Ms, Ms, Cfa, Rr, Ms, Ms, Ha, Ms, Ha, Rr, Rr, Ms, Ms, Ha^Fda, Ha, Ha^Fpa
Aa^Fpa, Ha^Fdw, Ha, Hh^Fpa, Hh^Fpa, Aa^Fpa, Gll, Aa, Gs, Aa, Gd, Aa, Ww, Wwg, Rp, Gd, Gd, Gd, Hh, Gd, Gd, Gd, Gd, Gd, Ha, Ha, Ms, Ms, Ms, Ms, Ms, Ms, Rr, Rr, Rr, Ms, Ms, Ms, Ms, Ms, Cfa, Rr, Mm, Ms, Ha^Fpa, Ha^Fda, Ha^Fpa
Ha, Ha, Aa^Fpa, Hh^Fpa, Gll, Aa^Fpa, Gd, Gd, Gd, Gd, Gd, Gs, Ww^Bw/r, Ww^Bw/r, Rp, Gd, Gd^Fdw, Hh, Gd, Gd, Gd, Gd, Gd, Ha, Aa, Ha, Ha, Ha, Ms, Ms, Ms, Ha, Ha, Rr, Ha, Ms, Ms, Ms, Ms, Ms, Ha, Rr, Rr, Ha^Fpa, Ms, Ha^Fpa, Ha^Fpa
Ha, Ha, Ha, Gd, Aa^Vaa, Gd, Aa, Gd, Rd, Rd, Gd, Gs, Ds, Ww, Rp, Rd, Aa, Aa, Gd^Vhr, Gd, Gd, Gd, Hh, Aa, Aa, Ha, Aa, Ha, Ha, Ha, Ha, Ha, Ha, Rr, Ha, Ha, Ha, Ha, Ha^Fda, Ha^Fda, Ha, Ha, Rr, Ms, Ms, Ms, Ms
Ha, Ha, Ha, Gd, Gd, Aa, Gd^Vhr, Rd, Rd, Gd, Gd^Vhr, Gd, Ds, Ww, Ww, Rp, Ai, Gd, Gd, Gd, Cer, Gd, Gs, Gd, Aa, Aa, Ha, Aa, Gd, Gd, Aa, Gd, Gd, Rr, Gd, Gd, Aa, Ha, Aa, Aa^Fda, Aa, Gd, Gd, Ms, Ms, Ms, Ms
Ms, Ha, Ha, Ha, Ha, Aa, Aa, Gd, Gd, Gd, Aa^Fpa, Gs, Gd, Ds, Ww, Rp, Rp, Aa, Gd, Gd, 3 Ker, Cer, Gd, Gd, Gd^Eff, Aa, Hh, Hh, Gd, Re^Gvs, Re^Gvs, Aa, Aa, Rp, Ha, Gd, Aa^Fda, Aa^Fda, Aa, Ha, Aa, Aa, Aa, Ms, Ms, Ms, Gd^Fdw
Ms, Ms, Ha, Gd, Aa^Fda, Gd, Aa, Gd, Aa^Fpa, Aa^Fpa, Aa^Vea, Gd, Gs, Gs, Ww, Rp, Rp, Aa, Gd, Cer, Cer, Cer, Gd, Gd^Eff, Gd^Eff, Aa, Gd, Gs, Gd, Re^Gvs, Gd^Es, Gs, Gd, Rp, Gd, Aa, Aa, Ha, Ha, Gd, Aa, Aa, Ms, Ms, Ms, Ms, Ms
Ms, Ms, Ha, Ha, Gd, Aa^Fda, Gd, Aa^Fpa, Gd, Aa^Fpa, Aa^Fpa, Gs, Gs, Gd, Ww, Wwg, Rp, Gg^Es, Gd, Gd, Gd, Gd, Gs^Eff, Gs^Eff, Hh, Gd, Gs, Gd, Gd^Vhr, Gs, Aa, Aa, Rp, Rp, Gd, Aa, Gd, Aa^Fda, Aa, Gd, Ha, Aa^Vla, Gs, Ms, Ms, Ms, Ms
Ha, Ha, Ha, Aa^Fda, Aa^Fda, Aa^Fda, Gd, Aa^Fpa, Gd, Gd, Gd, Gd, Gs, Gd, Ds, Ww, Rp, Ds, Hh, Gd, Gd, Gs^Eff, Gd, Hh, Gd, Aa, Aa, Gs, Gd, Gd, Gs^Gvs, Aa, Rp, Gd, Gd, Gd, Gd, Gd, Gd, Ha, Gs, Gg, Ms, Re^Gvs, Re^Gvs, Re^Gvs, Ms
Ha, Ha, Aa^Fda, Aa^Fda, Gg^Fda, Gd, Hh^Fda, Ha, Aa^Fpa, Aa^Fpa, Gd, Hh, Hh, Hh, Ds, Wwf, Ww, Rp, Ds, Hh, Gs, Aa, Aa, Gd, Gd, Gd, Gg^Gvs, Gg^Gvs, Gd^Gvs, Gg^Gvs, Gd, Gs, Aa, Gs, Gs, Gg^Vhh, Gg^Gvs, Gd, Gg, Gd, Ms, Ms, Ms, Ms, Ms, Gd, Gd
Ha, Ha, Aa^Fpa, Aa^Feta, Aa^Fpa, Aa^Fpa, Aa^Fpa, Hh^Fda, Gs^Fda, Aa^Vea, Gg, Hh, Gs, Gs, Gs, Wwf, Ww, Rp, Rp, Gd^Vhr, Gd, Gs, Gd, Aa, Aa, Gs^Es, Aa, Gd, Gd, Gg^Gvs, Gd, Gd, Aa, Gd, Gd, Gs^Gvs, Gs^Gvs, Gd^Gvs, Gs, Hh, Hh, Ms, Ms, Ms, Ms, Gd, Gd
Hh^Fda, Gs^Fda, Aa^Fpa, Aa^Fpa, Gg^Fda, Gs^Fda, Gs^Fda, Aa^Fpa, Aa^Fpa, Rp^Fda, Aa, Aa, Rp, Rp, Rp, Ds, Ww, Wwg, Wwg, Rp, Re, Gd, Gs, Aa, Aa, Aa, Gs, Gd, Gd, Gd, Gs, Gs, Aa, Aa, Gd, Gd, Gd, Gd^Fmf, Gll^Fp, Hh^Fdf, Hh^Fmf, Gs, Gll^Fp, Ms, Ms, Ms, Ms
Gs^Fda, Aa^Fpa, Hh^Fda, Aa^Fpa, Aa^Fpa, Aa^Fpa, Rp^Fda, Gs^Fda, Hh^Fda, Hh^Fda, Gs, Aa, Gs, Aa, Aa, Rp, Rp, Wwf, Ww^Bw/, Ww^Bw/, Rd, Rp, Gd, Gd, Rp, Gs, Gs, Rp, Rp, Gd, Aa, Aa, Aa, Gs, Gs, Gg^Es, Gd, Gll, Gll^Fmf, Hh^Fmf, Gg^Fdf, Hh^Fmf, Gs^Fmf, Gd, Gd, Gd, Re
Gg^Fda, Gd^Fda, Rp^Fda, Aa^Fpa, Aa^Fpa, Hh^Fda, Gs^Fda, Gs, Gg, Gs, Gs, Aa, Gs, Gs, Aa, Aa, Gd, Gd, Gg, Ww, Ww, Rd, Rp, Gd, Gd, Rp, Gd, Gs^Vc, Gs, Rp, Gd, Aa, Rp, Gs, Gd, Gd, Re, Re, Re, Gs, Re, Re, Re, Gd, Re, Re, Re
Aa^Fda, Aa^Fpa, Aa^Fpa, Aa^Fpa, Aa^Fpa, Gs^Fda, Hh^Fp, Gll^Fp, Gll, Gs, Gs, Aa, Gll, Aa, Gd, Aa, Aa, Gd, Gd, Rp, Ds, Ww, Ww, Rd, Rd, Gd, Gd, Gd, Gd, Gs, Gs, Gd, Re, Re, Re, Re, Ww, Ww, Ww, Re, Ww, Re, Ww, Re, Ww, Ww, Ww
Aa^Fda, Aa^Fda, Aa^Fda, Gs^Fda, Gg^Fp, Hh^Fp, Gg, Gll^Fp, Gs^Ve, Gg^Fmf, Gll^Fp, Gll, Gll^Fmf, Gll, Gs, Aa, Gg^Gvs, Gg^Gvs, Gd, Gs, Gd, Ww, Ww, Wwg, Wwg, Wwg, Rd, Gs, Rd, Ds, Ww, Re, Ww, Ww, Ww, Ww, Ww, Ww, Ww, Ww, Wwf, Ww, Wwf, Ww, Ww, Ww, Gll
Gs^Fmf, Aa^Fda, Gg^Fdf, Gs^Fp, Gs^Fp, Gg^Fdf, Gs^Fmf, Gll^Fp, Gll, Gll^Fp, Gll^Fmf, Gll^Fmf, Gd^Fp, Gs, Gd, Aa, Gd, Gd, Gs^Vl, Gd, Gs, Ds, Ds, Ww, Ww, Wwg, Ww, Rd, Ww, Ww^Bw\, Ww^Bw\, Ww, Ww, Ww, Ds, Wwf, Gd, Rp, Rp, Gs, Gll, Gs^Vc, Gll^Fmf, Gs^Fmf, Gll^Fmf, Gll^Fmf, Gll^Fmf
Gs^Fmf, Gs^Fp, Gg^Fp, Gg^Fdf, Hh^Fmf, Hh^Fdf, Hh^Fdf, Hh^Fmf, Gs^Fp, Gd^Fp, Gg^Fp, Gll^Fp, Gll, Gd^Fmf, Gs, Gd, Aa, Aa, Aa, Gs, Aa, Gd, Gs, Gs, Gs, Ww, Ww, Ww, Ww, Ww, Ds, Rd, Gg, Ds, Gd, Gd, Gg^Es, Gd, Gd, Rp, Gd, Gll^Fmf, Gg, Gll^Fmf, Gll, Gll^Fmf, Gg^Em
Gs^Fmf, Gd^Fp, Gs^Ve, Gs^Fdf, Hh^Fmf, Gs, Gs^Fp, Gs^Fmf, Gs^Fp, Gg^Fmf, Gg^Fp, Gll^Es, Gll^Fmf, Gs, Gll, Gs, Gs, Gg^Gvs, Gd, Aa, Aa, Aa, Aa, Gs, Gs, Gg, Gs, Ds, Gs, Ds, Gs, Gs, Aa, Gs, Gs^Vh, Gd, Gs, Gd, Gs, Gd, Ce, Ce, Ce, Gs, Gll^Fmf, Gll^Fmf, Gll^Fmf
Gs^Fmf, Gg^Fmf, Gs^Fmf, Hh^Fmf, Hh, Gs^Fmf, Cv, Cv, Gg^Fmf, Gd^Fdf, Gs^Fmf, Gll^Fmf, Gll^Vh, Gll^Fmf, Gll^Fmf, Gd^Fmf, Gg^Fmf, Gll^Fmf, Gll, Gd, Gd, Gs, Gs, Gs^Es, Gs, Hh, Hh, Hh, Hh, Gs, Gs, Aa, Gg^Gvs, Gs, Gg^Gvs, Gd, Gg^Gvs, Gs^Gvs, Gs, Gd, Ce, 1 Ke, Ce, Gs, Gs, Gll, Gs
Gg^Fmf, Gll^Fmf, Gll^Fdf, Gs, Gs^Fp, Gs^Fmf, Cv, 4 Kv, Cv, Gg^Fmf, Gll^Fp, Gs^Em, Gll^Fmf, Gll^Fp, Gll^Fp, Gll^Fp, Gll^Fmf, Gs^Fmf, Gs^Fmf, Gll^Fmf, Gll^Fmf, Gs^Fmf, Gll^Fmf, Gd, Hh, Hh, Mm, Hh, Hh, Hh, Gd, Aa, Gd, Gg^Gvs, Gg^Gvs, Gd^Gvs, Gs, Gg, Gd, Gs, Gd, Ce, Gd, Gs, Gg^Vl, Gd, Gg^Gvs
Gs^Fmf, Gll^Fdf, Gll^Fdf, Gll^Fdf, Gll^Fdf, Gg^Fdf, Gg, Cv, Gg^Fmf, Gg^Fmf, Gll^Fp, Gll^Fmf, Gg^Fmf, Gll^Fmf, Gg^Fp, Gll^Fp, Hh^Fp, Gs^Fmf, Gll^Fmf, Gll^Fmf, Gll^Vl, Gll^Fmf, Gg^Fp, Gg^Fmf, Hh^Fp, Mm, Mm, Mm, Hh, Gd, Gs, Aa, Gd, Gd, Gll^Fp, Gll, Gll^Fmf, Gs^Fp, Gs, Gd, Gd, Gd, Rp, Gd, Gs, Gs^Gvs, Gs
Gg^Fmf, Gll^Fdf, Gll^Fmf, Gll^Fmf, Gll^Fmf, Gll^Em, Gll^Fmf, Gll, Gg^Fmf, Gg^Fp, Gll, Gg^Fmf, Gg^Fmf, Gg^Fmf, Gg^Fmf, Hh^Fmf, Hh, Gs^Fp, Gll^Fdf, Gll^Fmf, Gll^Em, Gll^Fmf, Gg, Hh^Fmf, Hh^Fp, Hh^Fp, Hh^Fmf, Hh, Gg, Gd, Gs, Gs, Gs, Gd, Gll^Fp, Gll^Em, Gg^Fp, Gll^Fmf, Gs^Eff, Gs^Eff, Gs^Eff, Gs, Gg, Rp, Gg^Gvs, Gs^Gvs, Gg
Gs^Fmf, Gll^Fp, Gll^Fmf, Gll^Fmf, Gll^Fp, Gll^Fmf, Gll^Fmf, Gll, Gll^Fmf, Gll^Fmf, Gll, Gll^Fmf, Gll^Fp, Gg^Ve, Gd^Fp, Hh^Fp, Hh, Gs^Fdf, Gg^Fmf, Gll^Fmf, Gll^Fmf, Gll^Fmf, Gd^Fp, Gs^Fmf, Gll^Fmf, Gs^Fmf, Gll, Gg, Gs^Es, Gs, Gs, Hh, Hh, Gs, Gd, Gll^Fmf, Gd^Fmf, Gg^Eff, Gg^Eff, Gs^Vwm, Gs, Gs, Gs, Rp, Gg, Gg^Gvs, Gd
Gll^Fp, Gll^Fp, Gll^Fp, Gll^Fp, Gll^Fmf, Gll^Fp, Gll^Fdf, Gll^Fp, Gg^Fdf, Gll^Fp, Gs^Fmf, Gll, Gll^Fmf, Gg^Fmf, Gg^Fp, Hh^Fp, Gs^Fmf, Hh^Fmf, Gll^Fp, Gll^Fmf, Gll^Fp, Gll^Fp, Gll^Fmf, Gll^Fmf, Gll^Fmf, Gll^Fmf, Gll^Fmf, Gll, Gg, Gg, Hh, Hh, Hh^Vhh, Gs, Gd, Gs, Gd, Gd, Gd, Gd, Gd^Gvs, Gd, Gs, Rp, Gg, Gd, Gg
Gs, Gll^Fp, Gd^Fmf, Gll^Fmf, Gg, Gs^Fmf, Gs^Fmf, Gll^Fmf, Gll, Gll^Fmf, Gll, Gll, Gll, Gs^Fmf, Gs, Gll^Fmf, Gll, Gll^Fmf, Gs, Gg^Fp, Gs^Fmf, Gs^Fp, Gs^Fmf, Gs^Fmf, Gs, Gg^Fmf, Gs, Gll^Fmf, Ww, Gd, Hh, Hh, Hh, Hh, Gd, Gg^Es, Gs, Gs, Gs, Gd, Gs, Gs, Gs, Gs, Gs, Rp, Rp
