Xu, Xu, Xu, Xu, Xu, Xu, Xu, Xu, Xu, Xu, Xu, Xu, Xos, Xu, Xos, Xu, Xos, Xu, Xu, Xu, Xu, Xu, Xu, Xu, Xu, Xu, Xos, Qxu, Xos, Xu, Xu, Xu, Wog, Wog, Xu, Xu, Xu, Urb, Xu, Xu, Xu, Xu
Xu, Xu, Xu, Xu, Xu, Xu, Xu, Xu, Xu, Xu, Xu, Xu, Re, Xu, Rd, Xu, Re, Xu, Xu, Xu, Tb^Tf, Xu, Xu, Xu, Xu, Xu, Xos, Qxu, Xos, Xu, Xu, Xu, Wog, Wog, Wog, Xu, Xos, Xu, Xu, Xu, Urb, Urb
Xu, Xu, Xu, Xu, Uu, Kh, Cud, Xu, Uu, Xu, Re^Edb, Rd^Edb, Re^Edb, Rd^Edb, Re, Re^Es, Re^Edb, Rd^Edb, Re^Edb, Xu, Uu^Es, Tb^Tf, Uh, Xu, Xos, Xos, Urb, Urb, Cud, Xos, Xos, Xu, Xuc, Wog, Wog, Wog, Wog, Xos, Urb, Urb, Urb, Urb
Xu, Xu, Xu, Xu, Xu, Cud, Uu, Xu, Uu, Xu, Re, Chr^Eb, Re^Edb, Re, Ch, Re^Edb, Rd, Chr^Eb, Re, Xu, Uu, Uu^Es, Uu, Xu, Cud, Cud, Urb, Urb, Urb, Cud, Xuc, Xuc, Cud, Wwg, Wwg, Wog, Wog^Bs/, Wog^Bs/, Wog, Xos, Xu, Xu
Xu, Xu, Xu, Xu, Xu, Cud, Uu, Uu, Uu, Xu, Rd, Re^Es, Re^Es, Chr^Edb, Kh, Chr, Re, Rd^Edb, Re, Xu, Xu, Xu, Xu, Xu, Urb, Urb, Urb, Urb, Urb, Urb, Urb, Cud, Cud, Cud, Cud, Wwg^Bs/, Wwg, Wog, Wog, Xos, Xos, Xu
Xu, Xu, Xu, Xu, Xu, Cud, Xu, Xu, Xu, Xu, Re, Rd^Edb, Re^Edb, Chr, Ch, Chr, Re^Edb, Re, Rd, Xu, Xu, Xu, Xu, Urb, Urb, Urb, Urb, Urb, Urb, Urb, Urb, Cud^Ebn, Cud, 2 Kud, Cud, Cud, Cud, Xuc, Wog, Xos, Xos, Xu
Xu, Xu, Xu, Xu, Xu, Xu, Xu, Xu, Xu, Xu, Re, Chr^Eb, Re, Re, Re, Rd^Edb, Re, Chr^Eb, Re, Xu, Xu, Xu, Xuc, Cud^Eb, Urb, Urb, Urb, Urb, Urb, Urb, Rr, Rr, Urb, Cud^Ebn, Urb, Cud, Xuc, Xuc, Wwg, Wog, Xos, Xu
Xu, Xu, Xu, Xu, Qxu, Xu, Xu, Cud, Rd, Uu, Uu, Re^Edb, Xu, Rd, Re^Es, Re^Es, Xu, Re, Xu, Xu, Xu, Xu, Xu, Xu, Urb, Urb, Urb, Urb, Rr, Rr, Urb, Urb, Urb, Urb, Urb, Urb, Xu, Xu, Wwg, Wog, Xos, Xos
Xu, Xu, Qxu, Qxu, Uh^Vu, Uh, Re, Rd, Uu, Urb, Cud, Xu, Xu, Xu, Xu, Xu, Xu, Xu, Xu, Xu, Xu, Xu, Xos, Xos, Urb, Urb, Rr, Rr, Urb, Urb, Urb, Urb, Urb, Urb, Xos, Cud, Xu, Xu, Wwg, Wwg, Xos, Xos
Xu, Xu, Qxu, Qxu, Re^Es, Uh, Uu, Uu, Re, Tb^Tf, Xu, Xu, Xu, Xu, Xos, Xos, Xoc, Xu, Xu, Xu, Xos, Xos^Efs, Urb, Urb^Pr\, Rr^Pr\, Rr, Urb, Urb, Urb, Urb, Cud, Urb, Xof, Rr^Pr/, Re^Ii, Xof, Xof, Xof, Wwg, Xos, Xos, Xos
Xu, Xu, Tb^Tf, Rd, 7 Kud, Cud, Uu, Uu^Vu, Uu, Uh, Xu, Xu, Xos, Xos, Urb, Urb, Xos, Xu, Xu, Xos, Cud, Urb, Rr, Rr, Urb, Urb^Pr\, Xos, Xos, Xos, Xu, Xu, Xu, Xof, Xof, Re^Ii, Urb^Ii, Uu, Wwf, Chw, Xof, Xof, Xos
Xu, Xu, Uh^Tf, Uu^Tf, Cud, Cud, Uu, Re, Re, Urb, Urb, Xos^Efs, Xos, Urb, Xos^Efs, Xos, Urb, Xoc, Xu, Xos, Urb, Rr, Urb, Urb, Xos^Efs, Xos, Xos, Xos, Xu, Xu, Xu, Xu, Xof, Urb, Uu, Re^Es, Wwf, Chw, Kh, Wog, Wog, Xof
Xu, Xu, Uu^Tf, Uh, Uu, Uu, Uu, Uu, Uu, Uu, Xos, Xoc, Rr, Urb, Urb, Xos, Urb, Xos, Xos, Xos, Cud, Rr, Rr, Urb, Urb, Xos^Efs, Xu, Xu, Xu, Xu, Xu, Xu, Xu, Xof, Xof, Xof, Wwf^Vm, Chw, Wwf, Wog, Wog, Wog
Xu, Xu, Xu, Re, Uu, Uu, Uu^Vud, Xu, Uu, Xu, Xos, Xos, Urb, Rr, Rr, Urb, Urb, Xos, Xos, Xos, Urb, Urb, Rr, Rr, Rr, Urb, Urb, Xu, Xu, Xu, Xu, Xu, Xu, Xu, Xu, Xu, Wwf, Wwf^Em, Xu, Xu, Xu, Wog
Xu, Xu, Xu, Uh, Uh, Uu, Xu, Xu, Xu, Xu, Xu, Xos, Xos, Urb, Urb, Rr, Cud, Cud, Urb, Urb, Rr, Rr, Xos, Urb, Urb, Rr, Rr, Urb, Urb, Xu, Xu, Xu, Xu, Xu, Xu, Re, Re, Xu, Xu, Xu, Xu, Xu
Xu, Xu, Xu, Xu, Rd^Es, Re, Xu, Xu, Xu, Cud, Xu, Xu, Xu, Xos, Xos, Cud, Rr, Cud, Rr, Rr, Xu, Xu, Xu, Xos, Xos, Urb, Urb, Rr, Rr, Xuc, Xu, Xu, Xu, Xu, Wwg, Wwg, Xu, Xu, Xu, Xu, Xu, Xu
Xu, Xu, Xu, Xu, Rd^Es, Xu, Xu, Cud, Rr, Rr, Rr, Xu, Xu, Xoc, Cud, Urb, Rr, Rr, Urb, Cud, Xu, Xu, Qxu, Xu, Xu, Xos, Xos, Urb, Rr, Xuc, Xuc, Cud, Xu, Xu, Wwf, Re^Es, Xu, Xu, Xu, Xu, Xu, Xu
Xu, Xu, Xu, Xu, Rd^Es, Xu, Xu, Xu, Rr, Rr, Cud, Xoa, Xos, Xoc, Rr, Rr, Urb, Rr, Rr, Urb, Urb, Cud, Xu, Xu, Xu, Xu, Xos, Urb, Rr, Urb, Rr, Rr, Rr, Xu, Xu, Re^Es, Wwf, Xu, Xu, Xu, Xu, Xu
Xu, Xu, Uu, Re, Xu, Xu, Xu, Rr, Rr, Cud, 3 Kud, Cud, Rr, Rr^Pr\, Rr^Pr\, Urb, Cud, Urb, Urb, Rr, Rr, Urb, Cud, Xu, Xu, Xuc, Urb, Urb, Rr, Rr, Urb, Urb, Rr, Rr, Xu, Xu, Xu, Wwg, Xu, Xu, Xu, Xu
Xu, Xu, Uu, Xu, Xu, Cud, Rr, Rr, Rr, Cud, Cud, Cud, Rr, Urb, Xu, Xos, Xos, Xos, Xos, Urb, Rr, Urb, Xu, Qxu, Xu, Xuc, Xoc, Rr, Urb, Urb, Xu, Xu, Kh, Ch, Ch, Xu, Xu, Wwg, Wwf, Xu, Xu, Xu
Xu, Xu, Uu, Xu, Xu, Xu, Cud, Rr, Rr, Xu, Xu, Urb, Xu, Xu, Xu, Xos, Xos, Xu, Xos, Urb, Kud, Urb, Xu, Xu, Xu, Xuc, Urb, Xoc, Xoc, Xos, Xu, Xu, Xu, Ch, Xu, Xu, Wwf, Wwf, Xu, Wwf, Xu, Xu
Xu, Xu, Re, Xu, Xu, Xu, Xu, Rr, Rr, Cud, Xu, Xu, Xu, Xu, Rr, Urb, Xos, Xu, Xos, Cud, 4 Cud, Cud, Xu, Xu, Xu, Xos, Cud, Cud, Cud, Xos, Xu, Xu, Wog, Xu, Wwg, Wwf, Xu, Xu, Xu, Wwf, Xu, Xu
Xu, Xu, Rd, Xu, Xu, Xu, Cud, Rr, Xu, Xu, Xos, Xu, Urb, Urb, Rr, Urb, Xos, Xu, Xu, Urb, Rr, Urb, Xu, Xu, Xu, Xos, Urb, Rr, Urb, Xos, Xu, Wog, Wog^Ii, Wog, Wwg, Wwf, Wwf, Xu, Xu, Wwf, Wog, Xu
Xu, Xu, Rd^Es, Xu, Xu, Xu, Xu, Cud, Xu, Xos, Xos, Cud, Rr, Rr, Urb, Cud, Xos, Xu, Xu, Urb, Rr, Urb, Xu, Xu, Xu, Xos, Urb, Rr, Urb, Xos, Xu, Wog, Wog, Wog, Wwg, Wwg, Wwf, Xu, Xu, Xu, Xu, Xu
Xu, Xu, Xu, Re^Es, Re, Xu, Xu, Xu, Xu, Xos, Xos, Urb, Rr, Urb, Xos, Xos, Xu, Xu, Xu, Urb, Rr, Urb, Xu, Xu, Xu, Xos, Urb, Rr, Urb, Xos, Xu, Xu, Wwg, Wwg, Wwg, Wwg, Wwf^Es, Xu, Xu, Xu, Xu, Xu
Xu, Xu, Xu, Xu, Uu, Xu, Xu, Xu, Xu, Xos, Xos, Urb, Rr, Urb, Xos^Efs, Xos, Xu, Xu, Xu, Urb, Cud, Urb, Xu, Xu, Xu, Xos, Urb, Rr, Urb, Xos, Xu, Xos, Xu, Wwg, Xu, Wwf^Es, Wwf, Xu, Xu, Xu, Xu, Xu
Xu, Xu, Xu, Xu, Uu, Xu, Xu, Xu, Xu, Xos, Xos, Urb, Rr, Urb, Urb, Xos, Xu, Xu, Xu, Cud, Ur, Cud, Xu, Xu, Xos, Xos^Efs, Urb, Rr, Urb, Xos, Xu, Xu, Rr, Xu, Rr, Xu, Xu, Uu, Uu, Xu, Xu, Xu
Xu, Xu, Xu, Xu, Uu, Xu, Xu, Xu, Xu, Xos, Xos, Urb, Urb, Rr, Rr, Urb, Xur, Xu, Uu, Rr^Eb, Ur, Rr^Eb, Uu, Xu, Xur, Urb, Rr, Rr, Urb, Xos, Xu, Wwg, Rr, Rr, Rr, Rr, Xu, Xu, Uu, Uu, Xu, Xu
Xu, Xu, Xu, Xu, Xos, Xos, Xos, Xu, Xu, Xu, Xu, Xos, Xos, Urb, Xur, Xur, Xu, Uu, Uu, Uu, Ur, Uu, Xu, Xu, Xu, Xur, Xur, Urb, Xos, Xos, Xu, Xu, Xu, Rr, Xu, Xu, Uh^Vu, Xu, Uu, Re, Uu^Es, Xu
Xu, Xu, Xu, Xu, Xos, Uu, Uu, Xu, Xu, Xu, Xu, Xu, Xu, Xu, Xu, Xu, Xu, Xu, Uu, Uu, Ce, Uu, Uu, Xu, Xu, Xu, Xu, Xos, Xu, Xu, Xu, Xu, Xu, Xu, Uu^Vu, Uh, Uh, Uh, Uu, Re, Uu^Vu, Xu
Xu, Xu, Xu, Xu, Xos, Xos^Efs, Uu, Uh, Xos, Qxu, Qxu, Xu, Xu, Xu, Xu, Xu, Xu, Uu, Uu, Ce, 1 Ke, Ce, Uu, Xu, Xu, Xu, Xu, Xu, Xu, Xu, Xu, Xu, Xu, Xu, Uh, Uh, Uu^Es, Uu, Uu, Xu, Xu, Xu
Xu, Xu, Xu, Xos, Uu, Uu, Uu, Uh, Xos, Qxu, Qxu, Xu, Xu, Xu, Xu, Xu, Xu, Xu, Uu, Ce, Ce, Ce, Ur, Ur, Ur, Xu, Xu, Xu, Xu, Xu, Xu, Xu, Xu, Uh, Uu, Uu, Re, Re, Xu, Xu, Xu, Xu
Xu, Xu, Xu, Cud, Urb, Urb, Xos, Xos, Uu, Uh, Xu, Xu, Xos, Xos^Efs, Xu, Xu, Xu, Xu, Xu, Uu, Ur, Ur, Xu, Uu, Uu, Ur, Uu, Xu, Xu, Xu, Xu, Xu, Xu, Uh, Uu, Rd^Es, Uu, Uh, Xu, Xu, Xu, Xu
Xu, Xu, Xu, Urb, Urb, Urb, Urb, Urb, Urb, Uu, Xos^Efs, Xos, Urb, Urb, Rr, Xu, Xu, Xu, Uu, Uu, Ur, Uu, Xu, Xu, Uu, Ur, Ur, Uu, Uu, Xu, Xu, Xu, Xu, Uh^Vu, Uu, Rd, Uh, Uu^Vud, Xu, Xu, Xu, Xu
Xu, Xu, Xos, Xu, Urb, Urb, Urb, Urb, Xuc, Xos, Urb, Urb, Rr, Rr, Urb, Urb, Xos, Xu, Xu, Uu, Ur, Uu, Xu, Xu, Xu, Uu, Uu, Ur, Uu, Xu, Xu, Xu, Xu, Xu, Uu, Rd, Xu, Xu, Xu, Xu, Xu, Xu
Xu, Xos, Urb, Urb, Cud, Urb, Urb, Urb, Xuc, Xuc, Urb, Rr, Urb, Urb, Xos, Xos, Xu, Xu, Xu, Uu, Ur, Uu, Xu, Xu, Xu, Xu, Uu, Ur, Xu, Xu, Uh, Rd^Es, Re, Uu, Uu, Re, Xu, Xu, Xu, Xu, Xu, Xu
Xu, Xos, Urb, Cud, Kud, Cud, Rr, Urb, Urb, Cud, Rr, Rr, Urb, Xos, Xos, Xu, Xu, Xu, Xu, Uu, Ur, Uu, Xu, Xu, Xu, Xu, Uu, Ur, Ur, Xu, Re, Re^Es, Uu, Re, Xu, Xu, Xu, Xu, Xu, Xu, Xu, Xu
Xu, Xos, Urb, Cud, Cud, Cud, Urb, Rr, Rr, Rr, Urb, Urb, Urb, Cud, Xos, Xu, Xu, Xu, Xu, Uu, Ur, Uu, Xu, Xu, Xu, Xu, Xu, Uu, Uu, Ur, Uu, Uu, Uu^Vud, Uh, Xu, Xu, Xu, Xu, Xu, Xu, Xu, Xu
Xu, Xos, Xu, Urb, Urb, Urb, Urb, Urb, Urb, Urb, Urb, Urb, Cud, Cud, Xos, Xu, Xu, Xu, Xu, Uu, Ur, Uu, Xu, Xu, Xu, Xu, Xu, Xu, Xu, Uu^Vu, Xu, Xu, Xu, Xu, Xu, Xu, Xu, Xu, Xu, Xu, Xu, Xu
Xu, Xos, Xos, Xu, Cud, Urb, Xos, Xos, Xos, Urb, Cud, Cud, Xu, Xu, Xu, Xu, Xu, Xu, Xu, Uu, Ur, Uu, Xu, Xu, Xu, Xu, Xu, Xu, Xu, Xu, Xu, Xu, Xu, Xu, Xu, Xu, Xu, Xu, Xu, Xu, Xu, Xu
Xu, Xos, Xos, Urb, Xu, Xu, Xu, Xu, Xu, Xos, Xos, Xu, Xu, Xu, Xu, Xu, Xu, Xu, Xu, Uu, Ur, Uu, Xu, Xu, Xu, Xu, Xu, Xu, Xu, Xu, Xu, Xu, Xu, Xu, Xu, Xu, Xu, Xu, Xu, Xu, Xu, Xu
Xu, Xu, Xu, Xu, Xu, Xu, Xu, Xu, Xu, Xu, Xu, Xu, Xu, Xu, Xu, Xu, Xu, Xu, Xu, Uu, Ur, Uu, Xu, Xu, Xu, Xu, Xu, Xu, Xu, Xu, Xu, Xu, Xu, Xu, Xu, Xu, Xu, Xu, Xu, Xu, Xu, Xu
