Rp, Rp, Hh, Hh^Fp, Hh^Fms, Gll^Fp, Gll^Fp, Gg, Hh, Mm, Hh, Ms, Ms, Ms, Ms, Ms, Ms, Ms, Wog, Ha, Ha, Ms, Ms, Ms, Ms, Ms, Ms, Ms, Ms, Mm^Xm, Mm^Xm, Mm^Xm
Gs^Fp, Rp, Rp, Rp, Rp, Gll^Fp, Gd^Fp, Gll^Fp, Gll^Fp, Hh^Fp, Ms, Ms, Ms, Ms, Ms, Ms, Ms, Ms, Wog, Ha, Ai, Ms, Ms, Ms, Ms, Ms, Ms, Ms, Ms, Mm^Xm, Mm^Xm, Mm^Xm
Gll^Fp, Gll^Fp, Gll^Em, Gg, Rp, Gs, Gll, Gll^Fmw, Ss, Gll^Fp, Hh, Hh^Fp, Hh^Fp, Ms, Hh^Fp, Ms, Ha, Wwg, Wwg, Wog, Ai, Ms, Hh, Hh^Vud, Gs^Fms, Ms, Ha, Ha, Ms, Ms, Ms, Mm^Xm
Gll^Fp, Gd^Fmf, Gll^Fmf, Ce, Ce, Ce, Ce, Gll^Fmf, Ss, Sm, Gll^Fp, Hh^Fmf, Hh^Fmf, Hh^Fp, Ha, Ha, Ha, Wwg, Ha, Ai, Ai, Hh, Aa, Aa, Rp, Gs^Fms, Aa, Ha, Ha, Ms, Ms, Ms
Gll^Fmw, Gll^Fmw, Gll, Ce, Ce, 1 Ke, Ce, Gll^Fmf, Gs, Ss, Aa, Hh^Fmf, Ha, Ha, Gg^Fet, Ha, Gs^Efm, Ha, Ha, Gs, Rp, Aa, Rp, Rp, Ha, Rp, Rp, Rp, Rp, Ha, Ha, Ha
Gll^Fp, Gll^Fp, Gll^Fmf, Ce, Aa, Ce, Rp, Gs, Rp, Rp, Rp, Re, Re, Aa, Gs, Gg^Efm, Aa, Aa, Rp, Rp, Aa, Rp, Ha, Aa, Ha, Ha, Mm, Ha, Ha, Rp, Rp, Rp
Hh^Fp, Gll^Fp, Hh^Fp, Gs, Ha, Aa, Aa, Rp, Aa, Aa, Gs^Efm, Aa, Aa, Rp, Rp, Rp, Rp, Rp, Ha, Ha, Ha, Ha, Ms, Ha, Cfa, Cfa, Cfa, Mm, Ha, Rp, Aa, Aa
Hh, Hh^Fp, Ms, Aa, Ha^Vhha, Ha, Ha, Ha, Ha, Ha, Ha, Gs^Efm, Ha, Gs, Rp, Rp, Ha, Ha, Ha^Vhha, Ms, Ms, Ms, Ms, Ms, Cfa, 3 Kte, Cfa, Ha, Rp, Rp, Aa^Vca, Aa
Ms, Ms, Ms, Ms, Ms, Ms, Ms, Ha, Ms, Ha, Ms, Ha, Ha, Gg, Rp, Gg, Ha, Ha, Ms, Ms, Ms, Ms, Aa, Ms, Ms, Cfa, Ms, Ha, Ms, Rp, Ha, Ha
Ms, Ms, Ms^Xm, Ms, Ms, Ms, Ms, Ms, Ms, Ms, Ha, Ha, Wwg, Ch^Fet, Wwf, Ch^Fet, Ha, Ha, Ha, Ms, Ha, Ms, Aa, Ms, Ha, Ha, Ha, Ms, Rp, Rp, Ha, Ha
Ms, Ms, Ms, Ms, Ha, Ms, Aa, Ms, Ms, Ms, Ha, Wwg, Wog, Wwg, Wwg, Wwf, Wwf, Ha, Wwg, Ha, Wwg, Aa, Wwg, Aa, Wwg, Ha, Wwg, Ms, Rp, Ha, Ms, Ms
Ms, Ms, Ms, Ms, Aa, Aa, Wwg, Ms, Aa, Ha, Wwg, Wwg, Wog, Wog, Wwg, Wwf, Wwf^Es, Wwg, Wog, Wwg, Wog, Wwg, Wog, Wog, Wog, Wwg, Wwg, Ha, Rp, Ms, Ms, Ms
Wog, Wog, Wog, Wog, Wog, Aa, Wog, Wwg, Wwg, Wwg, Wwg, Wwg, Wog, Wog, Wog, Wwg, Wwf^Es, Wwg, Wog, Wog, Wog, Wog, Wog, Wog, Wog, Wog, Ha, Ha^Vhha, Rp, Ms, Ms, Ms
Wog, Wog, Wog, Wog, Wog, Wog, Wog, Wog, Wog, Wog, Wog, Wog, Wog, Wog, Wwg, Wwg, Wwf, Wwg, Wwg, Wwg, Wwg, Wog, Wwg, Wog, Ds, Wog, Mm, Ha, Rp, Ms, Ha, Ha
Wog, Wog, Wog, Wog, Wog, Wog, Wog, Wog, Wog, Wog, Wog, Wog, Wwg, Wwg, Wwf, Wwg, Wwf, Wwf, Hhd, Wwg, Hhd^Fp, Wwg, Wwg, Gll^Fet, Gll^Fp, Wwg, Wwg, Ha, Wwg^Bw|, Ha, Wwg, Wwg
Wwg, Wwg, Aa, Wog, Wwg, Wog, Wwg, Wog, Wog, Wog, Wog, Wog, Wwg, Ha, Ha, Ha, Gg, Re^Es, Re, Hhd^Fp, Hhd^Fp, Hh^Fp, Gll^Fp, Gll^Fp, Gll^Fp, Ds, Re, Wwg, Aa, Wwg, Ms, Mm^Xm
Wwg, Wwg, Aa, Aa, Aa, Wwg, Ha^Vhha, Wwg, Aa, Aa, Aa, Aa, Ha, Ha, Gs, Ha, Gs, Rp, Rp, Hhd^Fp, Gll^Fp, Hh^Fp, Re^Fp, Gll^Fp, Gs, Rp, Re, Re, Ms, Aa^Vha, Ms, Ms
Ha, Ha, Ha, Aa, Ha, Ha, Ms, Ha, Ms, Aa, Ha, Aa, Ha, Ha, Ha, Gg, Gg^Efm, Gs^Vh, Rp, Gll^Fp, Gll^Fp, Hh^Fp, Re^Fp, Gs^Em, Rr, Rr, Ha, Ms, Ms, Ms, Ms, Ms
Ms, Ms, Ms, Ha, Ms, Ms, Ms, Ms, Ms, Ms, Ms, Ha, Ha, Gs, Gs, Gg, Gg, Gs, Rp, Rr, Gll^Fp, Gll^Fp, Gll^Fp, Aa, Rr, Ha, Ha, Ms, Ms, Ms, Ms, Ms
Ms, Ms, Ms, Ms, Ms, Ms, Ms, Ms, Ms, Ms, Ms, Ha, Ha, Gg, Hh, Gs^Efm, Gs, Gs^Efm, Re, Rr, Rr, Rp, Rp, Rr, Aa, Aa, Chr, Ms, Chr, Ms, Ms, Ms
Ms, Ms, Ms, Ms, Ha^Vhha, Ms, Ha, Ha, Ha, Ms, Ha, Ha^Vhha, Chr, Hh^Fp, Gll^Fp, Rr, Rr, Rr, Re, Rr, Rp, Rp, Rp, Rp, Aa, Chr, Hh, Chr, Gg, Chr, Hhd^Fmw, Ms
Ms, Ms, Ms, Ms, Ms, Ha, Ms, Ha, Ha, Ha, Gs, Ha, Gg, Hh, Rp, Re, Hh, Re, Hh, Aa, Chr, Aa, Aa, Rp, Rp, Hh, Hh, Gs, Re, Gll^Fmw, Re^Fmw, Hhd
Ha, Ha, Ha, Ms, Ha, Ms, Gg, Ha, Gg, Gs, Gs, Gs, Gg, Rp, Chr, Hh, Ms, Ms, Hh, Aa, Chr, Re, Gll^Fp, Gll^Fmw, Rp, Rp, Re, Re, Gll, Re^Fmw, Gs, Hhd
Ha, Ha, Re, Re, Re, Re, Re, Gg, Re, Gs, Re, Re, Rp, Rp, Ms, Hh, Ms, Ms, Ms, Chr, Hh, Re, Gll^Fp, Gll, Chr^Dr, Rp, Chr, Chr, Chr, Re, Ha, Ha
Gg, Gg, Re, Gg, Gs^Fp, Gg, Ha, Re, Ha, Re, Ha, Ha, Ha, Ms, Ms, Ms, Ms, Ms, Ms, Chr, Hh^Fmw, Re^Fmw, Gs, Re, Chr^Dr, Chr, Chr, 2 Khr, Chr, Ha, Hh^Fp, Ha
Re, Re, Gg, Gs^Fp, Ha, Ha, Ms, Ms, Ms, Aa^Vca, Ms, Ms, Mm^Xm, Ms, Ms, Ms, Ms, Ms, Ms, Ms, Hhd, Hhd^Fmw, Re, Re, Gs, Rd, Chr, Chr, Ha, Ha, Hh^Fp, Hh^Fp
Re, Re, Ha, Ha, Ha, Ms, Mm^Xm, Mm^Xm, Mm^Xm, Ms, Ms, Ms, Ms, Mm^Xm, Mm^Xm, Ms, Ms, Ms, Ms, Ms, Hhd, Ms, Hhd, Re, Hh, Gs, Gg, Ha, Ha, Hh^Fmw, Hh^Fp, Mm
Re, Re, Rp, Ha, Ha, Ms, Ms, Ms, Ms, Ms, Ms, Ms, Ms, Ms, Ms, Ms, Ms, Ms, Mm^Xm, Ms, Ms, Ms, Ms, Chr, Chr, Hh, Chr, Mm, Mm, Mm, Mm, Mm
Gg, Gg, Re, Rp, Ha, Ha, Aa^Vca, Ha, Ha, Ms, Hh, Ms, Hh, Ms, Ms, Ms, Ms, Ms, Ms, Ms, Ms, Ms, Ms, Ms, Ha, Chr, Ha, Mm, Mm, Mm, Mm, Mm
Hh, Gg, Re, Rp, Gg, Ha, Ha, Ha, Ha, Hh^Fp, Hh^Fms, Hh^Fms, Hh^Fp, Hh, Ms, Ms, Hh^Ve, Ha, Ha, Ms, Ms, Ms, Ms, Ha, Ha, Ha, Ha, Ha, Mm, Mm, Mm, Mm
Hh, Gg, Hh, Rp, Rp, Gg^Efm, Gg, Gg^Efm, Gg^Efm, Gs^Fms, Gg^Fms, Hh^Fms, Gg^Fms, Hh^Fms, Hh, Hh, Gll^Fp, Ha, Ha, Ha, Ha, Ha, Ha, Ha, Hh^Fms, Hh^Fms, Ha, Ha, Ha, Mm, Mm, Mm
Ms, Ms, Ms, Hh, Hh, Rp, Rp, Rp, Rp, Gg, Gg, Gs^Fms, Rp, Gg, Rp, Gg, Gll^Fp, Gll^Fp, Gll^Fp, Gll^Fp, Gg, Gg, Gll^Fp, Hh^Fms, Hh^Fp, Hh^Fp, Hh^Fp, Ha, Ha, Ha, Mm, Mm
Ms, Ms, Ms, Ms, Mm^Xm, Hh^Fp, Hh, Gs, Hh, Rp, Rp, Rp, Gg, Rp, Gs, Re, Re, Hh, Hh, Gll^Fms, Gll^Fp, Gll^Fms, Hh^Fp, Gll^Fp, Hh^Fp, Mm, Mm, Ha, Hh^Fp, Mm, Mm, Hh
