Mm^Xm, Mm^Xm, Mm^Xm, Mm^Xm, Mm^Xm, Mm^Xm, Mm^Xm, Mm^Xm, Mm^Xm, Mm^Xm, Mm^Xm, Mm^Xm, Mm^Xm, Mm, Mm^Xm, Mm^Xm, Mm^Xm, Mm^Xm, Mm^Xm, Mm^Xm, Mm^Xm, Mm^Xm, Mm^Xm, Mm, Mm^Xm, Mm, Mm^Xm, Mm, Mm^Xm, Mm, Mm^Xm, Mm, Mm^Xm, Mm^Xm, Mm^Xm, Mm, Mm, Mm, Mm, Mm, Mm, Mm
Mm^Xm, Mm^Xm, Mm^Xm, Mm^Xm, Mm^Xm, Mm^Xm, Mm^Xm, Mm^Xm, Mm^Xm, Mm^Xm, Mm^Xm, Mm^Xm, Mm^Xm, Mm^Xm, Mm^Xm, Mm^Xm, Mm^Xm, Mm^Xm, Mm^Xm, Mm^Xm, Mm^Xm, Mm^Xm, Mm^Xm, Mm^Xm, Mm^Xm, Mm^Xm, Mm^Xm, Mm^Xm, Mm^Xm, Mm^Xm, Mm^Xm, Mm^Xm, Mm^Xm, Mm^Xm, Mm^Xm, Mm^Xm, Mm, Mm, Mm, Mm, Mm, Mm
Mm^Xm, Mm^Xm, Mm^Xm, Mm^Xm, Mm^Xm, Mm^Xm, Mm^Xm, Mm^Xm, Mm^Xm, Mm^Xm, Mm^Xm, Mm^Xm, Mm^Xm, Mm^Xm, Mm^Xm, Mm^Xm, Mm^Xm, Mm^Xm, Mm^Xm, Mm^Xm, Mm^Xm, Mm^Xm, Mm, Mm^Xm, Mm^Xm, Mm^Xm, Mm^Xm, Mm^Xm, Mm^Xm, Mm^Xm, Mm^Xm, Mm^Xm, Mm^Xm, Mm^Xm, Mm^Xm, Mm^Xm, Mm, Mm, Mm, Mm, Mm, Mm
Mm, Mm^Xm, Mm^Xm, Mm^Xm, Mm^Xm, Mm^Xm, Mm, Mm^Xm, Mm^Xm, Mm^Xm, Mm^Xm, Mm^Xm, Mm^Xm, Mm^Xm, Mm^Xm, Mm^Xm, Mm^Xm, Mm^Xm, Mm^Xm, Mm^Xm, Mm^Xm, Mm, Mm^Xm, Mm^Xm, Mm^Xm, Mm^Xm, Mm^Xm, Mm^Xm, Mm^Xm, Mm^Xm, Mm^Xm, Mm^Xm, Mm, Mm^Xm, Mm, Mm, Mm, Mm, Mm, Mm, Mm, Mm
Mm, Mm^Xm, Mm^Xm, Mm^Xm, Mm^Xm, Mm^Xm, Mm, Mm, Mm^Xm, Mm^Xm, Mm^Xm, Mm^Xm, Mm^Xm, Mm^Xm, Mm^Xm, Mm^Xm, Mm^Xm, Mm^Xm, Mm^Xm, Mm^Xm, Mm^Xm, Mm, Mm^Xm, Mm^Xm, Mm^Xm, Mm^Xm, Mm, Mm^Xm, Mm^Xm, Mm^Xm, Mm^Xm, Mm^Xm, Mm^Vhh, Mm, Mm, Mm, Mm, Mm, Mm, Mm, Mm, Mm
Mm, Mm, Mm, Mm, Mm, Mm, Mm, Mm, Mm^Vhh, Mm^Xm, Mm^Xm, Mm^Xm, Mm, Mm, Mm, Mm^Xm, Mm^Xm, Mm^Xm, Mm^Xm, Mm^Xm, Mm, Mm, Mm, Mm^Xm, Mm, Mm, Mm, Mm^Vhh, Mm, Mm, Md, Mm, Mm, Mm, Mm, Gs^Fp, Gs^Fp, Mm, Gs^Fp, Mm, Mm, Mm
Mm, Mm, Mm, Mm^Vhh, Mm, Mm, Mm, Mm, Mm, Mm, Mm, Mm, Mm^Vhh, Mm, Mm, Mm, Mm, Mm, Mm, Mm^Vhh, Mm, Mm, Mm, Mm, Mm, Mm, Mm, Mm, Mm, Md, Md, Md, Md, Mm, Gs^Fp, Gs^Fp, Gs^Fp, Gs^Fp, Gs^Fp, Gs^Fp, Mm, Mm
Mm, Mm, Mm, Mm, Hh, Hh, Hh, Mm, Mm, Mm, Mm, Mm, Mm, Mm, Mm, Mm, Mm, Mm, Mm, Mm, Mm, Mm, Mm, Mm, Mm, Mm, Mm, Mm^Vhh, Mm, Md, Md, Md, Hh, Gs^Fp, Gll^Fp, Gs^Fp, Gll^Fp, Gs^Fp, Gg, Gg, Gll^Fp, Gll^Fp
Hh, Hh, Mm, Hh, Hh, Hh, Hh, Hh, Hh, Mm, Hh, Hh, Mm, Mm^Vhh, Mm, Mm, Mm, Mm, Mm, Mm^Vhh, Mm, Mm, Mm, Mm, Mm, Mm, Gs^Vc, Mm, Hh, Mm, Hh, Hh, Gll^Fp, Gs^Fp, Gll^Fp, Gs^Vc, Gg, Gll^Fp, Gll^Fp, Gll^Fp, Gll^Fp, Gll^Fp
Hh, Hh, Hh, Hh, Gd, Gd, Hh, Hh, Hh, Hh, Hh^Fp, Hh, Mm, Mm, Mm, Mm, Mm, Mm, Mm, Mm, Mm, Mm^Vhh, Mm, Gs^Fp, Gs^Fp, Gs^Fp, Gs^Fp, Hh, Hh, Hh, Gll^Fp, Hh, Gll^Fp, Gll^Fp, Gll^Fp, Gll^Fp, Gg, Gg, Re, Gll^Fp, Re, Re
Gd, Gd, Gd, Gd, Re, Re, Hh, Hh, Hh^Fp, Hh^Fp, Hh^Fp, Hh^Fp, Hh^Fp, Gs^Fp, Gs^Fp, Mm, Mm, Mm, Mm, Mm, Mm, Mm, Gs^Fp, Gs^Fp, Gs^Vc, Gs^Fp, Gs^Fp, Gs^Fp, Gll^Fp, Gll^Fp, Gll^Fp, Gll^Fp, Gll^Fp, Gll^Fp, Re, Gg, Re, Re, Gs^Vc, Re, Re, Gg
Gd, Gd, Gs, Gs, Gs, Gs, Gs, Gs, Gs, Hh^Fp, Hh, Hh^Fp, Hh^Fp, Hh^Fp, Gs^Fp, Gs^Fp, Gs^Fp, Mm, Mm, Mm, Mm, Hh, Gs^Fp, Gs^Fp, Gs^Fp, Gs^Fp, Gg, Gs^Fp, Gll^Fp, Gll^Fp, Gll^Fp, Gll^Fp, Re, Re, Gg, Re, Gs^Fp, Gg, Ds, Gg, Ww, Ww
Gd, Gd, Gd^Vo, Gs, Gs, Gs, Gs, Gd^Vo, Gs, Gs, Gs, Gs, Co, Hh, Gs^Fp, Gs^Fp, Gs^Fp, Mm, Mm, Mm, Hh, Hh, Gll^Fp, Gg, Gll^Fp, Gll^Fp, Gll^Fp, Gll^Fp, Gll^Fp, Gll^Fp, Re, Re, Gg, Gg, Gg, Gg, Ww, Gs^Fp, Ww, Ww, Ww, Ww
Gd, Gd, Gd, Gd, Gd, Gs, Co, Co, Co, Gs, Gs, Gs, Co, Gs, Gg, Gs^Fp, Gs^Fp, Hh, Hh, Hh, Hh, Gll^Fp, Gll^Fp, Gll^Fp, Gll^Fp, Gll^Fp, Re, Gll^Fp, Re, Re, Gg, Gs^Vc, Gs^Fp, Gs^Fp, Ww, Ww, Ww, Ww, Gs^Gvs, Ds, Ds, Ds
Gd, Gd^Vo, Gd, Re, Gs, Gd^Vo, Co, 2 Ko, Co, Gd^Vo, Gs, Gs, Co, Gs, Gg, Gg, Re, Re, Re, Gg, Re, Gll^Fp, Re, Re, Re, Re, Gg^Gvs, Re, Gg, Gg, Gg^Gvs, Gg^Gvs, Ds, Ds, Ww, Ww, Gs^Gvs, Gs^Vh, Gs^Gvs, Gs^Gvs, Gs^Gvs, Gs^Fp
Gg, Gd, Gd, Gs, Gd, Gs, Gs, Co, Gs, Gs, Gs, Gs, Co, Gs, Re, Re, Ww, Ww, Ww, Re, Ww, Re, Ds, Gs^Vc, Gg^Gvs, Gg^Gvs, Gg^Gvs, Gg, Ww, Ds, Ww, Ww, Ww, Ww, Ds, Gs^Vh, Gs^Gvs, Gs^Gvs, Gs^Gvs, Gs^Vh, Ww, Ww
Gg, Hh, Hh, Gd, Hh, Gd, Gd, Gs, Gs, Gs, Gs, Gs, Rb, Rb, Ww, Ww, Ww, Ww^Ewf, Ww, Ww, Gs^Fp, Ww, Ww, Ds, Ww, Ds, Ww, Ds, Ww, Ww, Ww, Ww, Ww, Ww, Ww, Gs^Gvs, Ww, Gs^Vh, Ww, Ww, Ww, Ww
Gg, Hh, Mm, Hh, Mm, Hh, Hh, Gs, Gs, Gs, Re, Rb, Co, Co, Ww, Ww, Ww, Ds, Gs^Fp, Gs^Fp, Gs^Fp, Gs^Fp, Ww, Ww, Ww, Ww, Ds, Ww, Gll^Fp, Ww, Gll^Fp, Ww, Gll^Fmw, Ds, Ds, Ww, Ds, Ww, Gll^Fp, Gll^Fp, Gll^Fp, Gll^Fp
Mm, Mm, Mm, Mm, Mm, Mm, Gd^Vo, Hh, Hh, Re, Co, Rb, Ww, Ww, Ww, Ww, Gg, Gg^Efm, Gs^Fp, Gs^Fp, Gs^Vc, Ww, Ds, Ds, Ww, Ww, Gs^Vc, Gll^Fp, Gll^Fp, Gll^Fp, Gll^Fp, Gll^Fp, Gll^Fp, Gll^Fp, Gll^Fp, Gll^Fp, Gll^Fp, Gll^Fp, Gll^Fp, Gll^Fp, Hh, Hh
Mm, Mm, Mm, Mm, Mm, Hh, Hh, Hh, Hh, Co, Re, Rb, Ww, Ww, Ww, Gs^Vc, Gs^Fp, Gs^Fp, Gs^Fp, Gs^Fp, Ww, Ww, Ww, Ww, Gll^Fp, Gll^Fp, Gll^Fp, Gll^Fp, Mm, Gs^Vl, Mm, Gll^Fp, Hh, Hh, Mm, Mm, Mm, Hh, Hh, Hh, Mm, Mm
Mm, Mm, Mm, Gll^Fp, Gll^Fp, Mm, Hh, Hh, Re, Re, Rb, Rb, Ww, Ww, Ds, Gs^Fp, Gs^Fp, Gs^Fp, Gs^Fp, Gs^Fp, Ww, Ww^Ewf, Ds, Gll^Fp, Gll^Fp, Gll^Fp, Gll^Fp, Gll^Fp, Gll^Fp, Mm, Mm, Mm, Mm, Mm, Mm, Mm, Mm, Hh, Hh, Hh, Mm, Mm
Mm, Mm, Gll^Fp, Gll^Fp, Gs^Vc, Mm, Mm, Re, Re, Rb, Re, Gg, Ww, Ww, Ds, Gs^Fp, Gs^Fp, Gs^Vc, Ds, Ww, Ww, Ds, Gll^Fmw, Gll^Fp, Gll^Fp, Gll^Fp, Mm, Gll^Fp, Hh, Hh, Hh, Mm, Mm, Mm^Vhh, Mm, Mm, Mm, Mm, Mm, Mm, Mm, Mm
Mm, Mm, Gll^Fp, Gll^Fp, Gll^Fp, Gll^Fp, Gg, Gg, Re, Re, Gg^Vh, Gg^Gvs, Gg^Gvs, Ww, Ww, Gs^Fp, Ds, Ds, Ww, Ww, Ww, Ds, Gll^Fp, Gll^Fp, Gs^Vl, Mm, Mm, Hh, Hh, Hh, Hh, Mm, Mm, Mm, Mm, Mm, Mm, Mm, Mm, Mm, Mm, Mm
Mm, Mm, Gll^Fp, Gll^Fp, Gll^Fp, Gg, Gg, Gg^Vh, Re, Re, Gg, Gg^Gvs, Gg, Gg^Gvs, Gll^Fp, Ww, Ww^Ewf, Ww, Ww, Ww, Ww, Gll^Fp, Gll^Fp, Gll^Fp, Mm, Mm, Mm, Mm^Vhh, Mm, Mm, Mm, Mm, Mm, Mm, Mm, Mm, Mm, Mm, Mm^Xm, Mm^Xm, Mm^Xm, Mm^Xm
Mm, Mm, Gll^Fp, Gll^Fp, Gg, Gg, Gg, Re, Gg, Gg, Gg, Gg, Gs, Gll^Fp, Gll^Fp, Ww, Gll^Fp, Ww, Ww, Ww, Gll^Fp, Gs^Vc, Gll^Fp, Gll^Fp, Mm, Mm, Mm, Mm, Mm, Mm, Mm, Mm, Mm, Mm, Mm, Mm, Mm, Mm, Mm^Xm, Mm^Xm, Mm^Xm, Mm^Xm
Mm, Mm, Hh, Gs^Vc, Gg, Gg, Gg, Re, Re, Gg, Gg, Gg, Gll^Fp, Gll^Fp, Ww, Ww, Gll^Fp, Gg^Efm, Ww, Ww, Gll^Fp, Gll^Fp, Gll^Fp, Gll^Fp, Hh, Hh, Hh, Mm, Mm, Mm, Mm, Mm, Mm, Mm, Mm, Mm, Mm, Mm, Mm^Xm, Mm^Xm, Mm^Xm, Mm^Xm
Mm, Mm, Mm, Hh, Hh, Gg, Gg, Gg, Gg, Re, Gg, Gll^Fp, Gll^Fp, Ww, Ww, Gll^Fp, Gs^Vc, Ds, Ww, Ww^Ewf, Ww, Ds, Ds, Gll^Fp, Gll^Fp, Hh, Hh, Mm, Mm, Mm, Mm, Mm, Mm, Mm, Mm, Mm, Mm, Mm, Mm^Xm, Mm^Xm, Mm^Xm, Mm^Xm
Mm, Mm, Mm, Mm, Mm, Mm^Vhh, Mm, Mm, Ce, Ce, Ce, Gg, Gg, Ww, Ww, Ds, Ww, Ww, Ds, Ww, Ww, Ww, Ds, Gll^Fmw, Gll^Fp, Gll^Fp, Hh, Mm, Mm, Mm, Mm, Mm, Mm, Mm, Mm, Mm, Mm^Xm, Mm^Xm, Mm^Xm, Mm^Xm, Mm^Xm, Mm^Xm
Mm, Mm, Mm, Mm, Mm, Mm, Gll^Fp, Gg, Ce, 1 Ke, Ce, Gg, Gg, Ww, Ds, Ww, Gg, Ww, Gs^Fp, Gs^Fp, Ww, Ww, Gll^Fp, Gll^Fp, Gll^Fp, Gll^Fp, Mm, Mm^Vhh, Mm, Mm, Mm, Mm, Mm, Mm, Mm, Mm, Mm^Xm, Mm^Xm, Mm^Xm, Mm^Xm, Mm^Xm, Mm^Xm
Mm, Mm, Mm, Mm, Mm, Mm, Gll^Fp, Gll^Fp, Gll^Fp, Ce, Re, Gg, Re^Vct, Ww, Ww, Ww, Gs^Fp, Gs^Vc, Gs^Fp, Ww, Ds, Gs^Vl, Gll^Fp, Gll^Fp, Hh, Mm, Mm, Mm, Mm, Mm, Mm, Mm, Mm, Mm, Mm^Xm, Mm, Mm^Xm, Mm^Xm, Mm^Xm, Mm^Xm, Mm^Xm, Mm^Xm
Mm, Mm, Mm, Mm^Vhh, Gll^Fp, Gll^Fp, Gll^Fp, Gll^Fp, Gll^Fp, Gll^Fp, Re, Gg, Gg, Ww, Ww^Ewf, Ww, Gs^Fp, Gs^Fp, Ww, Ww, Gll^Fp, Gll^Fp, Gll^Fp, Gll^Fmw, Hh, Hh, Mm, Mm, Mm, Mm, Mm, Mm, Mm, Mm, Mm, Mm^Xm, Mm^Xm, Mm^Xm, Mm^Xm, Mm^Xm, Mm^Xm, Mm^Xm
Mm, Mm, Mm, Mm, Gll^Fp, Gll^Fp, Gll^Fp, Gg, Gg, Gg, Re, Gg, Gg, Ww, Ww, Ww, Gs^Fp, Gs^Fp, Ww, Ww, Gll^Fp, Gll^Fp, Gll^Fp, Gg, Hh, Hh, Mm, Mm, Mm, Mm, Mm, Mm, Mm, Mm, Mm, Mm^Xm, Mm^Xm, Mm^Xm, Mm^Xm, Mm^Xm, Mm^Xm, Mm^Xm
