Hhd, Hhd, Hhd, Hhd, Hhd, Hhd, Hhd, Hhd, Hhd, Hhd, Hhd, Hhd, Hhd, Hhd, Hhd, Hhd, Hhd, Hhd, Hhd, Hhd, Hhd, Hhd, Gd, Hh, Gd, Hh, Gd, Gd, Gd, Gd, Gd, Hhd, Hhd, Hhd, Hhd, Hhd, Gd, Gd, Gd, Gd, Gd, Hh, Gd, Gd, Gd, Hh
Hhd, Hhd, Hhd, Hhd, Gd, Hhd, Gd, Hhd, Hhd, Hhd, Hhd, Hhd, Hhd, Hhd, Hhd, Hhd, Hhd, Hhd, Hhd, Hhd, Hhd, Gd, Gd, Gd, Gd, Gd, Gd, Gd, Gd, Gd, Hhd, Hhd, Hhd, Hhd, Hhd, Gd, Gd, Gd, Gd, Gd, Gd, Gd, Gd, Gd, Gd, Gd
Gd, Gd, Gd, Gd, Gd, Gd, Gd, Gd, Hhd, Hhd, Hhd, Hhd, Hhd, Hhd, Hhd, Hhd, Hhd, Hhd, Hhd, Hhd, Hhd, Hhd, Hhd, Gd, Hhd, Gd, Gd, Gd, Gd, Gd, Gd, Hhd, Hhd, Hhd, Gd, Hhd, Gd, Gd, Gd, Gd, Gd, Gd, Gd, Gd, Gd, Gd
Gd, Gd, Gd, Gd, Gd, Gd, Gd, Gd, Hhd, Hhd, Hhd, Hhd, Gd, Gd, Hhd, Hhd, Hhd, Hhd, Hhd, Hhd, Hhd, Hhd, Hhd, Hhd, Hhd, Gd, Gd, Gd, Gd, Gd, Gd, Gd, Gd, Gd, Gd, Gd, Gd, Gd, Gd, Gd, Gd, Gd, Gd, Gd, Gd, Gd
Gd, Gd, Gd, Gd, Gd, Re^Vct, Ce, Hhd, Hhd, Hhd, Hhd, Gd, Hhd, Hhd, Hhd, Hhd, Hhd, Hhd, Hhd, Hhd, Hhd, Hhd, Hhd, Hhd, Hhd^Vhhr, Hhd, Hhd, Gd, Gd, Gd, Gd, Gd, Gd, Gd, Gd, Gd, Gd, Hhd, Hhd, Gd, Gd, Gd, Gd, Gd, Hhd, Hhd
Gd, Gd, Gd, Gd, Gd, Ce, 1 Ke, Ce, Hhd, Hhd, Hhd, Hhd, Hhd, Hhd, Hhd, Hhd, Wo, Wo, Wo, Hhd, Wo, Hhd, Hhd, Hhd, Hhd, Hhd, Hhd, Hhd, Gd, Gd, Gd, Gd, Gd, Gd, Gd, Gd, Hhd, Hhd^Vhhr, Hhd, Gd, Gd, Gd, Hhd, Hhd, Hhd, Hhd
Gd, Gd, Gd, Gd, Re^Vct, Ce, Ce, Ce, Hhd, Hhd, Hhd, Hhd, Hhd, Hhd, Hhd, Hhd, Wo, Wo, Wo, Wo, Wo, Wo, Hhd, Hhd, Hhd, Hhd, Hhd, Hhd, Hhd, Gd, Gd, Gd, Gd, Gd, Gd, Hhd, Hhd, Hhd, Gd, Gd, Gd, Gd, Hhd, Hhd, Hhd, Hhd
Gd, Gd, Gd, Gd, Gd, Gd, Hhd, Hhd, Hhd, Gd, Hhd, Hhd, Hhd, Hhd, Wwt, Wwt, Wwt, Wwt, Hh, Hh, Hh, Wo, Hhd, Hhd, Hhd, Hhd, Hhd, Hhd, Hhd, Hhd, Hhd, Hhd, Hhd, Gd, Gd, Hhd, Gd, Gd, Gd, Gd, Gd, Hhd, Gd, Hhd, Gd, Hhd
Gd, Gd, Gd, Gd, Gd, Gd, Hhd, Hhd, Gd, Gd, Hhd, Hhd, Mm, Hhd, Mm, Mm, Mm, Mm, Mm, Hh, Hh, Wo, Hhd, Hhd, Hhd, Hhd, Hhd, Hhd, Hhd, Hhd, Hhd, Hhd, Hhd, Gd, Hhd, Gd, Gd, Gd, Gd, Gd, Gd, Gd, Gd, Gd, Gd, Gd
Gd, Gd, Gd, Gd, Gd, Gd, Gd, Hhd, Hhd, Gd, Hhd, Mm, Mm, Mm, Mm, Mm, Mm, Mm, Mm, Mm, Wo, Wo, Hhd, Hhd, Mm, Mm, Mm, Hhd, Hhd, Hhd, Hhd, Hhd, Hhd, Hhd, Hhd, Hhd, Gd, Gd, Gd, Gd, Gd, Gd, Hhd, Gd, Gd, Gd
Gd, Gd, Gd, Gd, Gd, Gd, Gd, Hhd, Hhd, Hhd, Hhd, Mm, Mm, Mm, Mm, Mm, Mm, Mm, Mm, Mm, Wo, Hhd, Mm, Mm, Mm, Mm, Mm, Mm, Mm, Hhd, Hhd, Hhd, Hhd, Hhd, Hhd, Hhd, Hhd, Gd, Gd, Gd, Hhd, Hhd, Hhd, Hhd, Hhd, Hhd
Gd, Gd, Gd, Gd, Gd, Re^Vct, Ce, Hhd, Hhd, Hhd, Hhd, Hhd, Hhd^Vo, Mm, Hhd, Mm, Hhd, Hhd, Hhd, Wo, Wo, Hhd, Mm, Mm, Mm, Mm, Mm, Mm, Mm, Mm, Hhd, Hhd, Hhd, Hhd, Hhd, Hhd, Hhd, Gd, Hhd, Hhd, Hhd, Hhd, Hhd, Hhd, Hhd, Hhd
Gd, Gd, Gd, Gd, Gd, Ce, 2 Ke, Ce, Hhd, Hhd, Hhd, Hhd, Hhd, Hhd, Hhd, Hhd, Hhd, Hhd, Gg, Wo, Wwg, Wwg, Wwg, Mm, Wwt, Wwt, Gg, Mm, Mm, Mm, Hhd, Hhd, Hhd, Hhd, Hhd, Hhd, Hhd, Hhd, Hhd, Hhd, Re, Hhd, Re, Hhd, Re, Hhd
Gd, Gd, Gd, Re^Vct, Gd, Ce, Ce, Ce, Hhd, Hhd, Hhd, Hhd, Hhd, Hhd, Hhd^Vo, Hhd, Hhd, Hhd, Gg, Wwg, Wwg, Wwg, Wwg, Wwt, Gd^Vo, Gg, Hhd, Hhd, Hhd, Hhd, Hhd, Hhd, Hhd, Hhd, Hhd, Hhd, Hhd, Hhd, Re, Re, Hhd, Re, Hhd, Re, Hhd, Re
Gd, Gd, Gd, Gd, Gd, Hh, Re^Vct, Hhd, Hhd, Hhd, Hhd, Hhd, Mm, Hhd, Hhd, Hhd, Hhd, Hhd, Gg, Wwg, Wwg, Wwg, Gg, Gg, Re, Hhd, Hhd, Hhd, Hhd, Hhd, Hhd, Hhd, Hhd, Hhd, Hhd, Hhd, Re, Re, Hhd, Hhd, Hhd, Hhd, Hhd, Hhd, Hhd, Hhd
Gd, Gd, Gd, Gd, Gd, Gd, Gd, Gd, Hhd, Hhd, Hhd, Mm, Mm, Mm, Hhd, Hhd, Hhd, Gg, Gg, Wwg, Wwg, Wwg, Gg, Hh, Hh, Re, Re, Hhd, Re, Hhd^Vo, Re, Hhd, Re, Re, Re, Re, Hhd, Hhd, Hhd, Hhd, Hhd, Hhd, Hhd, Hhd, Hhd, Hhd
Re, Gd, Re, Gd, Re, Gd, Re, Re, Re, Re, Re, Mm, Mm, Mm, Hhd, Hhd^Vo, Hhd, Gg, Wo, Wo, Gg, Gg, Gg, Hh, Hh, Re, Hh, Re, Hh, Re, Gd, Re, Hhd, Hhd, Re, Hhd, Hhd, Hhd, Hhd, Hhd, Hhd, Gd, Hhd, Hhd, Hhd, Hhd
Gd, Re, Gd, Re, Gd, Re, Gd, Re, Hh, Re, Re, Hh, Re, Hhd, Hhd, Hhd, Wo, Wo, Hh, Hh, Hh^Vo, Hh, Hh, Hh, Hh^Vo, Hh, Hh, Hh, Hh, Hh, Gd, Gd, Gd, Gd, Re, Hhd, Hhd, Hhd, Hhd, Hhd, Gd, Gd, Hhd, Hhd, Hhd, Hhd
Gd, Gd, Gd, Gd, Gd, Gd, Gd, Gd, Hh, Hh, Hh, Re, Re, Re, Re, Re, Wo^Bw\, Co, Hh, Hh, Hh, Hh, Hh, Hh, Hh, Hh, Hh, Hh, Gd, Hh, Gd, Gd, Gd, Gd, Hhd, Re, Hhd, Hhd, Hhd, Hhd, Gd, Gd, Hhd, Hhd, Hhd, Hhd
Gd, Gd, Gd, Gd, Gd, Gd, Gd, Gd, Hh, Hh^Vo, Hh, Hh, Hh, Hh, Hh, Wo, Co, Re, Re, Re, Co, Co, Co, Hh, Hh, Hh, Hh^Vo, Hh, Gd, Gd, Hhd, Hhd, Gd, Gd, Re, Re, Hhd, Hhd, Hhd, Gd, Gd, Gd, Hhd, Hhd, Hhd, Hhd
Gd, Gd, Gd, Gd, Gd, Gd, Gd, Gd, Gd, Hh, Hh, Hh, Hh^Vo, Hh, Wo, Wo, Hh, Hh, Hh, Hh, Co, 5 Ko, Co, Co, Re, Hh, Re, Hh, Re, Hhd, Hhd, Hhd, Gd, Re, Re, Hhd, Hhd, Hhd, Gd, Gd, Gd, Hhd, Gd, Hhd, Hhd, Hhd
Gd, Gd, Gd, Gd, Gd, Gd, Gd, Gd, Gd, Hh, Hh, Hh, Wo, Wo, Hh, Hh, Hh, Hh, Hh, Hh, Hh, Co, Co, Co, Hh, Re, Hh, Re, Hhd, Re, Re, Re, Re, Re, Hhd, Hhd, Hhd, Gd, Hhd, Gd, Gd, Gd, Gd, Hhd, Hhd, Hhd
Gd, Gd, Gd, Gd, Gd, Gd, Gd, Gd, Gg, Gg, Gg, Wo, Wo, Mm, Mm, Mm, Mm, Hh^Vo, Hh, Hh, Mm, Hh, Mm, Hh, Mm, Hh^Vo, Mm, Mm, Mm, Hhd, Hhd, Re, Hhd, Hhd, Hhd, Hhd, Hhd, Hhd, Hhd, Gd, Hhd, Gd, Gd, Gd, Hhd, Hhd
Gd, Gd, Gd, Gd, Gd, Gd, Gg, Gg, Gg, Gg, Gg, Wo, Mm, Mm, Mm, Mm, Mm, Mm, Mm, Mm, Mm, Mm, Mm, Mm, Mm, Mm, Mm, Mm, Mm, Hhd, Re, Re, Hhd, Hhd, Gd^Vo, Hhd, Hhd, Hhd, Mm, Hhd, Hhd, Gd, Gd, Gd, Hhd, Hhd
Gd, Gd, Gd, Gd, Gd, Gd, Gg, Gg, Gg, Gg, Wo, Wo, Mm, Mm, Mm, Mm, Mm, Mm, Mm, Mm, Mm, Mm, Mm, Mm, Mm, Mm, Mm, Mm, Hhd, Hhd, Re, Hhd, Hhd, Hhd, Hhd, Hhd, Hhd, Mm, Mm, Mm, Hhd, Hhd, Gd, Gd, Hhd, Hhd
Gd, Gd, Gd, Gd, Gg, Gg, Gg, Gg, Wwg, Wwg, Wwg, Mm, Mm, Mm, Mm, Hh, Hh, Wwt, Hh, Mm, Hhd, Mm, Hhd, Mm, Hhd, Mm, Hhd, Hhd, Hhd, Hhd, Co, Hhd, Hhd, Hhd, Hhd, Hhd, Mm, Mm, Mm, Mm, Hhd, Hhd, Hhd, Hhd, Hhd, Hhd
Gg, Gd, Gg, Gg, Gg, Gg, Gg, Gg, Wwg, Wwg, Wwg, Hh, Hh, Mm, Hh, Hh, Wwt, Wwt, Hh, Gll^Fmf, Gll^Fmf, Hhd, Hhd, Hhd, Hhd, Hhd, Gd^Vo, Hhd, Hhd, Hhd, Co, 6 Ko, Co, Hhd, Hhd, Hhd, Mm, Mm, Mm, Mm, Hhd, Hhd, Hhd, Hhd, Gd, Hhd
Gg, Gg, Gg, Gg, Gg, Gg, Gg, Gg, Wwg, Wwg, Wwg, Hh, Hh, Hh, Wwt, Wwt, Hh, Hh, Hh^Vo, Gll^Fmf, Gll^Fmf, Gll^Fmf, Hhd, Hhd^Vo, Hhd, Hhd, Hhd, Hhd, Re, Re, Hhd, Co, Hhd, Hhd, Hhd, Mm, Mm, Mm, Mm, Mm, Hhd, Hhd, Gd, Gd, Gd, Gd
Gg, Gg, Gg, Gg, Gg, Gg, Wwg, Gg, Wwg, Wwg, Wwg, Hh, Wwt, Wwt, Hh, Wwt, Hh, Hh, Re, Gll^Fmf, Gll^Fmf, Hhd, Hhd, Hhd, Hhd, Hhd, Hhd, Hhd, Re, Re, Hhd, Hhd, Hhd, Hhd, Hhd, Mm, Mm, Mm, Mm, Mm, Hhd, Hhd, Gd, Gd, Gd, Gd
Gg, Gg, Gg, Gg, Wwg, Wwg, Wwg, Wwg, Wwg, Wwg, Wwt, Wwt, Hh, Hh, Hh, Hh, Hh, Hh, Re, Re, Hhd, Hhd, Hhd, Hhd, Ce, Hhd, Hhd, Re, Hhd, Hhd, Hhd, Gd^Vo, Hhd, Hhd, Ce, Hhd, Hhd, Mm, Hhd, Hhd, Gd, Gd, Gd, Gd, Gd, Gd
Gg, Gg, Gg, Wwg, Wwg, Wwg, Wwg, Wwg, Wwg, Wwg, Wwg, Gg, Hh, Hh, Hh, Hh, Gd, Gd, Gd, Re, Re, Hhd, Hhd, Ce, Ce, Ce, Re^Vct, Re, Gd, Hhd, Gd, Hhd, Hhd, Hhd, Ce, Ce, Hhd, Hhd, Gd, Gd, Gd, Gd, Gd, Gd, Gd, Gd
Gg, Gg, Gg, Wwg, Wwg, Wwg, Wwg, Wwg, Wwg, Wwg, Gg, Gg, Hh, Hh, Hh, Gd, Gd, Gd, Gd, Gd, Re, Gd, Re^Vct, Ce, Ce, 3 Ke, Gd, Gd, Gd, Gd, Gd, Gd, Re^Vct, Ce, Ce, Ce, Re^Vct, Gd, Gd, Gd, Gd, Gd, Gd, Gd, Gd, Gd
Gg, Gg, Gg, Wwg, Wwg, Wwg, Wwg, Wwg, Gg, Gg, Gg, Hh, Gd, Hh, Gd, Gd, Gd, Gd, Gd, Gd, Re, Gd, Re, Re, Gd, Gd, Gd, Gd, Gd, Gd, Gd, Gd, Gd, Gd, Gd, 4 Ke, Gd, Gd, Gd, Gd, Gd, Gd, Gd, Gd, Gd, Gd
Gg, Gg, Wwg, Wwg, Wwg, Wwg, Wwg, Wwg, Gg, Gg, Gd, Gd, Gd, Gd, Gd, Gd, Gd, Gd, Gd, Gd, Re, Re, Gd, Gd, Gd, Gd, Gd, Gd, Gd, Gd, Gd, Gd, Gd, Gd, Gd, Gd, Gd, Gd, Gd, Gd, Gd, Gd, Gd, Gd, Gd, Gd
Hh, Gg, Gg, Wwg, Wwg, Wwg, Wwg, Gg, Gg, Gg, Gd, Gd, Gd, Gd, Gd, Gd, Gd, Gd, Gd, Gd, Gd, Re, Gd, Gd, Gd, Gd, Gd, Gd, Gd, Gd, Gd, Gd, Gd, Gd, Gd, Gd, Gd, Gd, Gd, Gd, Gd, Gd, Gd, Gd, Gd, Gd
