Hh^Qhh, Mm^Qhh, Mm^Qhh, Gg^Qhh, Hh^Es, Hh^Qhh, Hh^Qhh, Gg^Qhh, Mm^Qhh, Mm^Qhh, Hhd^Qhh, Mm^Qhh, Hhd^Qhh, Mm^Qhh, Hh^Qhh, Gg^Qhh, Gg^Fds, Gg, Re^Qhu, Re^Qhu, Re^Qhu, Gg^Efm, Gg^Efm, Gg^Qhh, Gg^Qhh, Gg^Qhh, Gg^Qhh, Hh^Qhh, Hh^Qhh, Mm^Qhh, Hh^Qhh, Mm, Mm^Qhh, Gg, Mm^Xm, Mm^Xm, Mm^Xm, Hh, Hh^Fp, Gg^Fms, Hh^Qhh, Hh^Qhh, Mm^Qhh, Mm^Qhh, Mm^Qhh, Hh^Qhh, Hh^Qhh, Mm^Qhh, Mm, Mm, Mm^Xm, Gg^Qhh, Mm^Xm, Mm^Xm, Mm^Xm, Gg^Qhh, Mm, Mm
Hh^Qhh, Hh^Qhh, Hh^Qhh, Mm, Mm, Mm^Xm, Mm^Xm, Hh^_mh, Hd, Md, Hd, Md, Md, Hhd^Qhh, Hh^Fds, Gg^Fms, Gs^Fp, Gg^Qhu, Rb^Qhu, Re, Gg^Efm, Gg^Vhr, Gg^Efm, Gg^Qhu, Ce, Gg^Efm, Gs^Efm, Gg^Qhh, Gg^Qhh, Hh^Qhh, Hh^Qhh, Mm^Qhh, Hh^Qhh, Mm^Qhh, Hh^Fp, Mm^Xm, Mm, Mm^Xm, Hh, Gg^Fms, Gg, Hh^Fp, Gg^Fms, Gg^Fp, Hh, Mm^Qhh, Gg^Qhh, Hh^Qhh, Hh^Qhh, Hh, Hh^Es, Hh, Hh, Mm^Xm, Mm, Hh, Hh, Mm
Gs, Gg^Qhh, Hh, Hh^Qhh, Gg^Qhh, Hh^Qhhf, Hh^Qhhf, Mm, Hhd^Qhh, Dd, Dd, Dd, Hd, Hhd^Qhh, Hhd^Qhh, Gg^Fp, Gg^Fds, Gg^Fms, Gg^Qhuf, Re, Re, Rb, Re^Qhu, Ce, 1 Ke, Ce, Gg^Efm, Gs^Efm, Gs^Qhu, Gs^Qhu, Gd^Qhu, Hd^Qhu, Dd^Qhu, Hh^Qhh, Hh^Qhh, Gg^Fms, Gs^Qhh, Hh^Es, Hh, Gs, Gs, Gg, Gg, Gg^Fms, Gg, Hh, Hh^Vhh, Hh^Qhh, Gg, Gg^Qhh, Gg^Qhh, Gg, Hh, Hh, Hh^Es, Mm, Hh, Hh^Qhh
Hh, Gs^Fp, Gs^Fp, Hh, Hh, Gg^Fms, Gg, Gg^Qhh, Gg, Hd^Qhh, Hd^Qhh, Gg, Dd, Gg, Gg^Fds, Hh^Qhh, Gg^Fms, Gg, Gg, Re^Qhu, Gg^Qhuf, Re^Qhu, Gg, Ce, Ce, Ce, Rb, Rb, Gs^Efm, Gs, Gd, Ds, Ds, Ds^Qhu, Ds^Qhu, Ds^Qhh, Dd^Qhu, Gg^Qhh, Ds^Qhh, Hh, Gs, Hh, Mm, Gg^_mh, Hh^Es, Gg, Gg, Hh, Gs, Gg, Gg^Qhh, Gg, Gg, Re, Rb, Gg^_mhh, Rb, Rb
Gs^Fds, Gg^Fms, Gs, Gg, Gg, Hh, Gg^Fp, Hh^Fds, Hh, Gs^Fds, Gs^Fp, Hh^Qhhf, Hh^Qhh, Hhd^Es, Mm, Gg^Qhh, Hh^Qhhf, Gg^Fms, Hh^Fms, Gg, Gs^Fp, Gg, Gs^Fp, Gs^Fms, Gs^Fp, Re^Qhu, Gg^Qhuf, Re, Rb, Re, Re, Gs, Gs, Gd, Ds^Edp, Ds^_ml, Dd^Qhu, Dd^Qhu, Ds^Qhu, Ds^Qhh, Gg^Qhh, Gs^Qhh, Hh^Qhh, Mm^Qhh, Mm^Qhh, Mm^Qhh, Mm^Qhh, Gs, Gs, Gg, Gg, Gg^Qhh, Hh^Qhh, Re, Gg^Vl, Gg, Gs, Gs^Qhh
Gg^Fds, Gg, Gg^Fds, Gg, Gg, Gg, Gg, Gg, Gs^Fds, Gs^Fds, Gs^Fds, Gg^Fp, Gg, Hh^Qhh, Mm^Qhh, Mm^Xm, Mm^Xm, Mm^Qhh, Mm^Xm, Hh, Gs^Fms, Gg, Gg, Gg, Gs^Fp, Gs^Fms, Gs^Fds, Rb^Qhu, Rb, Re, Rb, Re, Rb, Gs, Gd, Dd^Qhu, Gs^Efm, Dd^Qhu, Dd^Qhu, Ds^Qhu, Ds^Qhu, Dd^Qhu, Hd^Qhu, Hh^Qhh, Hh^Qhh, Mm^Qhh, Mm^Qhh, Hh^Fp, Gg, Gs, Gg, Gg, Gg^Fp, Mm^Qhh, Mm, Hh, Hh, Hh^Qhh
Gg, Gg, Gg^Fms, Gg, Gg, Gg^Fms, Gg^Fds, Gg, Gs^Fds, Gs^Fds, Gs^Fds, Gg, Hh^Vo, Hh, Hh, Mm^Qhh, Hh^Qhh, Mm^Xm, Mm^Qhh, Hh^Qhhf, Hh, Gg, Gs^Fms, Gs^Fds, Gs^Fds, Gg, Gs^Fms, Gg^Qhu, Gg^Qhu, Gg, Gg, Re, Re, Re, Rb, Gg^Qhu, Gs^Qhu, Gs^Efm, Gs, Hd^Qhu, Ds, Ds^Qhu, Dd^Qhu, Hd^Qhu, Ds, Gs, Hh, Hh^Qhh, Hh^Qhh, Hh, Hh^Es, Gg, Gg^Efm, Hh^Qhhf, Mm^Qhh, Mm^Xm, Mm^Xm, Hh^Es
Gg, Gg, Gs^Fds, Gg^Fds, Gg, Gg^Fp, Gs, Gg, Gs, Gs^Fds, Gs^Fds, Gs^Fds, Gg, Hh, Gs, Hh, Gg, Hh^Qhh, Gg, Mm^Qhh, Hh^Qhh, Gg, Gg, Gg, Gg, Gs^Fms, Gg^Qhuf, Gg^Qhuf, Gg, Gg^Qhu, Gg^Qhu, Gg, Re, Rb, Re, Gg, Gg^Efm, Gs^Efm, Gs, Ds, Ds, Gs, Gs, Gs, Ds, Gs^Efm, Gg^Efm, Hh, Gg, Hh^Qhh, Gg^Qhh, Hh, Gg^Efm, Gg^Fms, Hh, Mm^Qhh, Hh^Qhh, Mm^Qhh
Gg, Gg^Fms, Gs^Fds, Gs^Fds, Gs^Fds, Gg, Gs, Gs^Fds, Gs^Fds, Gs^Fds, Gs^Fds, Gs^Fds, Gs^Fds, Gg, Gs^Vo, Gg, Gg^Fp, Gs, Gg^Fms, Hh, Hh, Hh^Qhh, Hh^Qhh, Gg^Fms, Gg, Gg^Qhu, Gg^Qhu, Gs, Gg^Fms, Gs, Gs, Gg^Efm, Gg^Efm, Rb, Rb, Re, Gs, Gs^Qhu, Gs^Qhu, Gg, Gg^Efm, Gg, Gg, Gs, Gg, Gg, Gg, Ds, Ds, Gg, Ds, Gg^Qhh, Gg^Qhh, Gg^Qhh, Gg^Qhh, Hh, Gg, Hh^Qhh
Gg, Gg, Gs^Fds, Gs^Fds, Gs^Fds, Gs, Gg, Gs^Fds, Gs^Fds, Gs^Fds, Gs, Gs^Fds, Gs, Gs, Gg^Fms, Gg^Fms, Gg, Gg^Fp, Gg^Fds, Gg, Gg, Gg, Gs, Gg, Gg, Gg, Gg, Gs, Gs, Gs, Rb, Gs^Vh, Gg^Fms, Gg^Efm, Re, Re^Edb, Re, Gg^Edb, Gs^Vhr, Gd^Qhu, Gs, Gs^Efm, Gs, Gs, Gs, Gs, Gg, Gg, Ds, Ds^Edp, Dd, Ds, Gg, Gg, Dd, Gg^Qhh, Gg^Qhh, Gg^Qhh
Gs, Gs, Gs, Gs^Fds, Gg, Gs, Gg, Gs^Fds, Gs^Fds, Gg, Gd^Ecf, Ce, 4 Ke, Gs, Gg, Gg^Fp, Gg, Gg, Gs^Fds, Gg^Fds, Gg^Efm, Gg, Gg, Gs, Gs, Gs, Gs, Gs, Rb, Rb, Gs, Gg^Qhu, Gg^Fms, Re, Rb^Qhu, Re, Gg, Gs^Edb, Gs^Qhu, Gd^Qhu, Gs, Gg, Gs, Gs, Gs, Gs, Gg, Gg, Gg, Ds, Gg, Ds, Ds, Gs, Gg, Ds, Ds, Gg^Qhh
Ds, Gg, Ds, Gs, Gs, Gg, Gg, Gs^Edb, Ds, Gd, Gd, Ce, Ce, Ce, Gg, Gg, Gs^Fds, Gs^Fds, Gs^Fds, Gs^Fds, Gs^Fds, Mm, Gs^Edb, Gs, Gs, Gs, Gd^Vo, Re^Edb, Gs, Gs^Edb, Re^Qhu, Rb^Fp, Gs, Rb^Qhu, Rb^Edb, Gs^Edb, Gg^Edb, Gg, Gs^Qhu, Gs, Gg, Gg, Gg^Edb, Gs, Gg, Gg^Edb, 5 Ke, Gg^Efm, Gs, Gg, Gg, Ds, Gg, Gg, Gg^Efm, Gg, Dd, Dd
Ww, Ds, Ds, Ds, Gs, Gg, Ds, Ds, Ds, Ds, Gg^Fds, Gs, Gs, Gg, Gs, Gg, Gs^Fms, Gs^Fds, Gs^Edb, Gs^Edb, Gs^Fds, Gs^Fds, Gs, Gs, Gd, Gd^Edb, Rb^Edb, Gs, Gs, Gg, Gg, Gs, Re^Edb, Gs^Ecf, Re, Re, Gs, Gg^Edb, Gs^Qhu, Gs, Gs^Efm, Gg, Gs, Gg, Gd^Edb, Ce, Ce, Ce, Gs^Vc, Gs^Edb, Gs^Edb, Gs, Gg, Gg^Efm, Gg^Efm, Gg, Gs, Dd
Wwg, Wwg, Wwg, Ds, Wwg, Gg, Wwrg, Wwrg, Ww, Ds, Ds, Gg^Fms, Gs^Vl, Gg^Fms, Gg, Gs^Fp, Gs, Gs, Gs, Gs^Fds, Gs^Fds, Gs^Fds, Gs, Gs, Gs, Gs, Re, Rb, Rb^Ecf, Rb, Gs, Gs, Gd^Edb, Re, Rb, Rb, Gs^Edb, Gs^Edb, Gs, Gd^Qhu, Gs, Gg, Gg^Efm, Gs^Edb, Gs^Vc, Gd^Edb, Rb^Ecf, Rb^Edb, Rb, Re, Re, Gs, Re, Gg, Gg, Gg, Gs^Efm, Gs
Wwg, Ww, Wwg, Wwg, Wwg, Wwg, Wwg, Wwg, Ww, Ww, Ww, Gs^Fp, Gs, Gs, Gs^Edb, Gg, Gg, Gs^Edb, Gd, Gd^Ecf, Gs, Gg, Gg^Edb, Gs, Gs^Edb, Gd^Vo, Gs, Re, Re, Rb, Gd, Gd^Edb, Co, Re, Re, Gs^Edb, Gs, Gg, Gs, Gd^Qhu, Gd^Qhu, Gg^Efm, Gg^Edb, Gs, Gs, Gd, Gs, Gs, Gd, Gd^Vc, Gd^Edb, Re, Re, Rb, Gg^Efm, Gs, Gg^Efm, Gs^Efm
Wwg, Wwg, Wwg, Wwg, Wwg, Wwg, Wog, Ww, Wwr, Ww, Ww, Ww, Gg^Fms, Gg^Fp, Gg^Fms, Gg, Gg, Gs, Gs, Gs, Gs, Hh, Hh, Hh^Edb, Gg, Gs^Edb, Gs^Qhu, Re^Edb, Gs^Edb, Gs, Rb, Co, 3 Ko, Co, Gd^Ecf, Gs, Gs, Gg^Edb, Gg, Gs, Gs^Edb, Gd^Qhu, Gg^Efm, Gs, Gs, Gs, Gs, Gs, Gs, Gs, Gg, Re, Re, Gg^Efm, Re, Rb, Rb, Rb
Ww, Wwg, Wog, Wog, Wog, Wog, Wo, Wo, Wo, Wwr, Wwr, Ww, Gg^Fms, Gg^Fms, Hh, Gg^Fds, Hh, Gs, Gs, Gs, Gs^Edb, Hh^Edb, Gs, Gs, Gg, Gs, Gg, Gs^Edb, Re^Eqp, Re^Edb, Re, Co, Co, Co, Rb^Eqp, Co, Gs^Eqp, Gg, Ds, Gg, Gs, Ds^Qhu, Hd^Qhu, Gg, Gs^Edb, Gg, Ds, Gs, Ds, Gg, Ds, Gg, Gg, Re, Re, Gs, Gd^Ecf, Gg
Wwg, Wwg, Wog, Wog, Wog, Wog, Wo, Wo, Wo, Wwr, Ww, Ww, Ww, Ds, Ds, Hh, Hh, Hh, Hh, Gg, Gs, Gs, Gd^Vo, Gs, Gs, Gg^Edb, Gg^Vo, Gg^Eqp, Gg, Rb^Eqp, Gg^Eqp, Re, Rb^Eqp, Re^Eqp, Wwg, Rb, Wwg, Ds^Eqp, Ds^Eqp, Co^Edb, Ds^Eqp, Ds^Eqp, Wwg^Qhu, Gs, Wwg^Qhu, Wwg^Qhu, Wwg^Qhu, Ds, Ds, Ds, Ds, Gg^Edb, Gs, Re, Gs, Gs, Gs^Edb, Gd
Wog, Wog, Wog, Wog, Wog, Wo, Wo, Wo, Wo, Wo, Wo, Ww, Ww, Ww, Ds^Edb, Hh^Fp, Gg^Edb, Gs, Gs, Gs^Edb, Gs^Vo, Gd, Gs, Gs, Ds, Ds^Edb, Ds, Ds, Wwrg, Gg, Gg, Co^Qhu, Gg, Wwg, Wwg, Wwg, Wwg, Wwg, Wwg, Ds, Wwg, Wwg, Wwg^Qhu, Wwg^Qhu, Wwg, Wwg^Qhu, Ww^Qhu, Ww^Qhu, Ww^Qhu, Ww^Qhu, Ww^Qhu, Ds, Ds, Re, Gd, Gs, Gs, Gd
Wog, Wog, Wog, Wog, Wo, Wo, Wo, Wo, Wo, Wo, Wo, Ww, Ww, Ww, Ds, Ds, Gg, Gs^Edb, Ds, Ds, Ds, Gs, Hh^Edb, Gs, Ds, Ds, Wwg, Wwrg, Wwg, Wwg, Wwg, Gg, Wwf, Wwg, Wwg, Wwg, Wwg, Wwg, Wwg, Wwg, Ww^Ewf, Wwg, Ww^Qhu, Ww, Ww, Ww, Ww, Ww, Ww, Ww, Wwr^Qhu, Ds, Ds, Gd^Vht, Gs^Edb, Gs, Gg^Edb, Gg
Wog, Wog, Wog, Wo, Wo, Wo, Wo, Wo, Wo, Wo, Ww, Ww, Ww, Ww, Ww, Ds, Wwg, Ds, Wwg, Ds^Edb, Ds^Edb, Hh^Edb, Hh, Ds, Wwrg, Ds, Wwg, Wwg, Wog, Wog, Wog, Wwf, Wwf, Wwg, Wwg, Wwg, Wog, Wog, Wog, Wwg, Ww, Ww, Ww, Ww, Ww, Ww^Ewf, Ww, Ww, Ww, Ww, Ww, Wwr^Qhu, Wwr^Qhu, Gs, Gg, Gs, Gg^Edb, Gg
Wog, Wog, Wo, Wo, Wo, Wo, Ww, Ww, Ww, Ww, Ww, Ww, Wwg, Ww, Wwg, Wwg, Wwg, Wwg, Wwg, Wwg^Edb, Wwg, Wwg, Wwg, Wwg, Wwg, Wwg, Wwg, Wwg, Wog, Wog, Ds, Wog, Ds, Wwf, Ww, Ww, Wo, Wo, Ww, Ww, Ww, Ww, Wo, Ww^_ml, Ww, Ww, Wo, Ww, Ww, Ww, Ww, Wwr^Qhu, Ww^Qhu, Gg, Gg^Edb, Ds, Ds, Gg
Wo, Wo, Wo, Ww, Ww, Wwr, Ds, Ww, Dd^Do, Ww, Wwg, Wwg, Wwg, Ww^Ewf, Wwg, Wwg, Wwg, Wwg, Wog, Wog, Wog, Wwg, Wwg, Wwg, Wwg, Wwg, Wog, Wog, Ds, Ds, Ds, Ds, Wwf, Wwf, Wwf, Wo, Wo, Wo, Ww, Ww, Ww, Wo, Wo, Wo, Wo, Wo, Wo, Wo, Ww, Ww, Ww, Ww, Ww, Ww^Qhu, Ww^Qhu, Ds, Ds, Gg
Wo, Wo, Wo, Wo, Wo, Ww, Wwr, Ds, Ds, Ds, Wwg, Wwg, Wwg, Wwg, Wog, Wwg, Wog, Wog, Wog, Wog, Wog, Wog, Wwg, Wwg, Wwg, Wwg, Wog, Wog, Wwf, Wwf, Ww, Ww, Wwf, Wwf, Wot, Wot, Wot, Ww, Ww, Ww, Ww, Ww, Ww, Wo, Wo, Wo, Wo, Wo, Ww, Ww, Ww, Ww, Ww, Ww, Ww, Ww^Qhu, Ww^Qhu, Ds
Wo, Wo, Wo, Wo, Wo, Wo, Wo, Wo, Wo, Wo, Wog, Wog, Wog, Wog, Wog, Wog, Wog, Wog, Wog, Wog, Wog, Wog, Wog, Wwg, Wo, Wog, Wo, Wo, Wo, Ww, Ww, Ww, Ww, Ww, Ww, Wot, Wwt, Ww, Wo, Ww, Ww, Ww, Ww, Ww, Ww, Ww, Wo, Wo, Ww, Ww, Ww^Vm, Ww, Ww, Ww, Ww, Ww, Ww, Ww^Qhu
Wog, Wog, Wo, Wo, Wo, Wo, Wog, Wo, Wog, Wog, Wog, Wog, Wog, Wog, Wog, Wog, Wog, Wog, Wo, Wog, Wog, Wog, Wo, Wo, Wo, Wo, Wo, Wo, Wo, Wo, Ww^Ewf, Ww, Ww, Ww, Wwt, Wwt, Wot, Wwt, Wo, Wo, Wwt, Wwt, Wwt, Wwt, Wwt, Wo, Ww, Ww, Wwt, Ww, Wwt, Ww, Wwt, Wwt, Ww, Ww, Ww, Ww^Qhu
Ww, Wog, Wog, Wo, Wog, Wog, Wog, Wog, Wog, Wog, Ww^Vm, Wog, Wog, Wog, Wo, Wo, Wo, Wo, Wo, Wo, Wo, Wo, Wo, Ww^Vm, Wo, Wo, Ww, Wo, Ww, Ww, Ww, Ww, Ww, Ww, Wwt, Wwt, Wot, Wot, Wot, Wwt, Wwrt, Wwt, Wwt, Wwt, Wwt, Wwt, Wwt, Wwt, Wwt, Wwt, Wo, Wwt, Wo, Wo, Wo, Ww, Wo, Wo^Qhu
Ds, Ww, Wog, Wog, Wog, Wog, Wog, Wog, Wog, Wog, Wog, Wog, Wog, Wog, Wog, Wo, Wo, Wo, Wo, Wo, Wo, Wo, Wo, Wo, Wo, Wo, Ww, Ww, Ww, Ww, Ww, Ww, Wwf, Wwf, Wwf, Wwt, Wwt, Wot, Wwt, Wwrt, Wwt, Wwt, Wwt, Wwt, Wwt, Wwt, Wwf, Wwt, Wo, Wo, Wo, Wo, Wo, Wo, Wo, Wo, Wo, Wo^Qhu
Gs, Wog, Wog, Wog, Wog, Wog, Wog, Wog, Wog, Wog, Wog, Wog, Wog, Wog, Wo, Wo, Wo, Wo, Wo, Wo, Wo, Wo, Wo, Wo, Wo, Ww, Ww, Ww, Wwf^Edt, Wwf, Wwf, Wwf, Wwf, Wwf, Wwf, Wwt, Ce, Ce, Ds, Ds, Ds, Ww, Ds, Wwf, Wwf, Wwf, Wwf, Ww, Ww, Wo, Wo, Wo, Wo, Wo, Wo, Wo, Wo, Wo^Qhu
Gs, Gs, Ds, Wog, Wwg, Wog, Wog, Wog, Wog, Wog, Wog, Wog, Wog, Wog, Wog, Wo, Wo, Wo, Wo, Wo, Wo, Wo, Ww, Wo, Wwf, Wwf, Wwf, Ww^Ewf, Wwf, Wwf, Ds, Ds, Ds, Wwf^Edt, Ds, Ds, Ce, 2 Ke, Gs, Gs, Gs, Ds, Gs^Vh, Ds, Gs, Ds, Ds, Wwf, Ww, Wo, Wo, Wo, Wo, Wo, Wo, Wo, Wo, Wo^Qhu
Gg, Gg^Edb, Ds, Ds, Wwg, Wwg, Wwg, Wwg, Wog, Wog, Wog, Wog, Wog, Wog, Wog, Wog, Wog, Wo, Wo, Wo, Ww, Ww, Ww, Ww, Ds, Ds^Edt, Ds, Ds, Ds, Ds, Gs, Ds, Gs^Vh, Ds^Edt, Gs^Edb, Gs, Gs, Ce, Gs, Gd, Gs^Vh, Gs, Gs^Edb, Gs, Gs, Gs, Gs, Ds^Edt, Ds^Edt, Ww, Ww, Ww^Edt, Ww, Wo, Wo, Wo, Wo, Wo^Qhu
Wog, Gg, Wog, Gg, Gg, Gs^Edb, Gs^Edb, Ds, Ds, Wog, Wog, Wog, Wog, Wog, Wog, Wo, Wwg, Wwg, Ww, Wwg, Ds, Ds, Ds, Ds, Gs, Gs, Gs, Ds, Gd, Gs, Gs, Re, Re, Gd, Gs, Gs, Gs, Re^Ecf, Gd, Re^Edb, Gs, Gs, Gs, Gd, Gd^Ecf, Gd, Gd, Gs, Ds, Ds, Ds, Ds, Ds, Ww, Ww, Ww, Wo, Wo^Qhu
