Gll^Fp, Gll^Fp, Gll^Fp, Hh^Fp, Hh^Fp, Hh, Mm, Mm, Mm, Mm, Mm, Mm, Mm, Mm, Mm, Mm, Mm, Mm^Xm, Mm^Xm, Mm^Xm, Xu, Xu, Cud, Uu, Uu, Xu, Uu, Rr, Rr^Br/
Gll^Fp, Gll^Fp, Gll^Fp, Gll^Fp, Hh^Fp, Hh, Mm, Mm, Mm, Mm, Mm, Mm, Mm, Mm, Mm, Mm, Mm, Mm^Xm, Mm^Xm, Mm^Xm, Xu, Xu, Uh^Vu, Uh, Uu^Vud, Uu^Vud, Rr^Br/, Rr^Br/, Rr
Gs, Gg^Ve, Gll^Fp, Gll^Fp, Gll^Fp, Hh^Vhh, Hh^Fp, Mm, Mm, Mm, Mm, Mm, Mm, Mm, Mm, Mm, Mm, Mm, Mm, Mm^Xm, Mm^Xm, Xu, Uh^Tf, Uu, Cud, Rr^Br/, Rr, Rr, Uu
Gll^Fp, Gll^Fp, Gll^Fp, Gll^Fp, Gs^Efm, Gll^Fp, Hh^Fp, Hh^Fp, Hh^Fp, Mm, Hh^Vhh, Mm, Mm, Mm, Mm, Hh^Vhh, Mm, Mm, Mm, Mm, Mm^Xm, Xu, Xu, Cud, 2 Kud, Cud, Uu, Uu^Vud, Uh
Gll^Fp, Gll^Fp, Gll, Gll, Gs, Gs, Gll^Fp, Hh^Fp, Gll^Fp, Hh, Mm, Mm, Hh^Fp, Hh^Fp, Hh, Hh, Mm, Mm, Mm, Mm, Mm^Xm, Xu, Xu, Cud, Re, Cud, Kud, Uu, Uh
Gll^Fp, Gll^Fp, Gs^Efm, Gs, Gg^Efm, Gg^Efm, Gs, Gg, Gll^Fp, Gll^Fp, Gll^Fp, Hh^Fp, Gll^Fp, Hh, Gll^Fp, Mm, Hh^Vhh, Mm, Mm, Mm, Md^Vhh, Xu, Re^Es, Re^Es, Re, Cud, Cud, Cud, Uu
Gg, Gg^Ve, Gg, Gs, Ce, Gs, Gg, Gg, Gg, Gg, Gg, Gll^Fp, Gs, Gll^Fp, Gg, Gll^Fp, Hh, Hh, Hhd, Md, Hhd, Hhd, Re, Re, Xu, Xu, Uh^Vud, Uu, Uh
Gs^Fp, Gs^Fp, Gg, Ce, Ce, Ce, Ce, Ce, Re, Gs, Gg, Gs, Gg^Es, Gs, Gg, Gg^Efm, Gg, Hh, Ce, Hhd, Re, Re, Md, Xu, Mm^Xm, Xu, Xu, Uh^Vu, Cud
Gg, Gg, Gs, Gs, Ce, 3 Ke, Ce, Ce, Gs, Re, Gs, Gs^Es, Gg, Gs, Gg, Gg^Efm, Gg, Gg, Rb, Re, Ce, Hhd, Hhd^Vhh, Md, Mm, Mm^Xm, Mm^Xm, Xu, Xu
Gg^Efm, Gs, Gs, Ce, Gg, Ce, Gg, Gg, Gs, Gg, Re, Gg, Gg^Vh, Gg^Efm, Gg^Efm, Gg, Gg, Rb, Gg, Rb, Gg, Hhd, Hh, Mm, Hh^Fp, Mm, Mm, Mm^Xm, Mm^Xm
Gg, Gs, Re, Re, Gg, Gg, Gg, Gg, Gs, Gg^Efm, Gg^Efm, Re, Gg, Gg, Rb, Gs, Rb, Rb, Gg^Efm, Gg, Gg, Hh, Hh^Fp, Hh^Fp, Hh^Fp, Hh, Hh^Fp, Mm^Vhh, Mm
Gs, Gg, Re, Gg, Gg, Gg^Efm, Gg^Efm, Gg, Gll^Fp, Gg, Gll, Gs, Gs, Gs, Gg, Rb, Gg, Rb, Rb, Gg, Gg, Gg, Gg, Gg, Gll^Fmw, Hh^Fp, Gg^Fp, Hh^Fp, Mm
Gs, Gg, Re^Vh, Gg, Gll, Gs^Efm, Gll^Fp, Gll^Fp, Gll^Fp, Gs^Vl, Gll^Fp, Gs^Fp, Gs^Fp, Gs^Fp, Gll^Fp, Gg, Gg, Gg^Vh, Gg, Gg^Efm, Gg, Gg^Efm, Gg, Gg, Gll^Fp, Gll^Fmw, Gll^Fmw, Gll^Fp, Gg^Fp
Gg, Gg, Gg, Gg, Gll, Gll^Fp, Hh^Fp, Gg^Fet, Hh^Fp, Gll^Fp, Hh^Fp, Gll^Fp, Gll^Fp, Gll^Fp, Gll^Fp, Gll, Gll^Efm, Gg^Efm, Gg, Rb, Gg, Gg^Efm, Gg^Efm, Gll^Fp, Gll^Fp, Gll^Fmw, Gll^Fp, Gll^Fmw, Hh
Gg, Gs, Gg, Gg, Hh^Fp, Hh^Fp, Mm, Hh, Hh, Hh^Fp, Hh, Hh, Mm, Hh^Fet, Hh^Fp, Gll^Fp, Gll^Fp, Gg^Efm, Gg^Efm, Rb, Rb, Gg, Gg, Gll^Fp, Gll^Fp, Gll^Fmw, Gg^Fet, Gll^Fp, Hh^Fp
Gg, Gs, Gg, Gg^Efm, Hh, Mm, Mm, Mm, Mm, Mm, Hh, Mm, Mm, Mm, Mm, Hh, Mm, Hh, Hh, Hh, Gg, Gg, Gg, Gg, Gs, Gll^Fmw, Gll^Fmw, Gll^Fmw, Hh^Fp
Gs, Gs^Es, Gg, Hh, Hh, Mm, Mm, Mm, Mm, Mm, Hh, Mm, Mm, Mm, Mm, Mm, Mm, Mm, Hh^Vhh, Hh, Gg, Re, Re, Gg, Gs, Gll^Fp, Gll^Fp, Gll^Fmw, Gll^Fp
Gg, Gg, Gg, Gg, Gll^Fp, Hh, Hh, Mm, Mm, Mm, Hh, Hh^Vhh, Mm, Mm, Mm, Mm, Mm, Mm, Mm, Hh, Hh, Gg, Rp, Gll, Gll, Gll^Fp, Gs^Vl, Gll^Fp, Gll^Fp
Ds, Ds, Gg, Gll^Fp, Hh^Fp, Hh^Vhh, Hh, Hh, Hh^Fp, Hh, Hh, Mm, Mm, Mm, Mm, Mm, Mm, Mm, Mm, Hh, Gg, Gs, Rp, Gs, Ce, Gll^Fp, Gll^Fp, Gll^Fp, Gll^Fp
Ww, Ww, Ds, Gll^Fp, Hh^Fp, Hh^Fp, Hh^Fp, Hh^Fp, Hh^Fet, Hh^Fp, Hh^Fp, Hh, Hh, Mm, Hh, Hh, Hh, Mm, Hh^Vhh, Hh, Gg, Ce, Ce^Es, Ce^Es, Ce, Ce, Hh^Fp, Gll^Fp, Gll^Fp
Ww, Ww, Ds, Gg^Fet, Gll^Fp, Rb, Hh^Fp, Hh^Fp, Gg, Gs^Ve, Gll^Fp, Gll, Gll^Fp, Hh, Gg, Hh, Gg, Hh, Gg, Gg, Re, Re, Ce, 4 Ke, Ce, Hh, Mm, Hh, Hh
Wo, Wo, Wo, Ww, Re, Gll^Fp, Ds, Gg, Gg, Gs^Fp, Gg, Gll^Fet, Re, Gg, Gg, Gg, Rp, Rp, Rp, Re, Gg, Ce, Hh^Fp, Ce, Hh, Mm, Mm, Mm, Mm
Wo, Wo, Wwt, Wo, Ww, Wwf, Wwt, Gs, Re, Gg, Re, Re, Gg, Re, Gg, Rp, Gg^Efm, Gg^Efm, Gg, Gg, Gg, Gll^Fp, Hh^Fp, Hh^Fp, Mm, Hh, Hh, Mm, Mm
Wo, Wo, Wwt, Wwt, Wwt, Wwt, Ds, Re, Gs^Edt, Rb, Gg, Gs^Edb, Gg, Gs, Gg, Gg, Gg^Efm, Gs^Vc, Gg, Gs, Gll^Fp, Gll^Fp, Gll^Fp, Gg^Ve, Mm, Mm, Hh^Vhh, Hh, Hh
Wo, Wwt, Wwt, Wwt, Wwt, Wwt, Ds, Ds, Gs^Edb, Rb, Gs, Gs, Gg^Vh, Gg^Edt, Gs, Gg, Gs, Gs, Gg^Efm, Gs, Gs^Fp, Gs^Fp, Hh, Hh, Hh, Hh, Mm, Mm, Mm
Wo, Wo, Wwt, Wwt, Wwf, Wwt, Ds, Ds, Gll, Rb, Gll, Gll, Gll^Fp, Gs, Gll, Gll, Gg, Gg^Efm, Gg^Efm, Gs, Hh, Hh, Mm, Mm, Mm, Mm, Mm, Mm, Mm
Ww, Ww, Ww, Wo, Wwf, Wwf^Edt, Gll, Gd^Edb, Gll^Fp, Rb, Rb, Gll^Fp, Gll^Fp, Gll^Fp, Gll^Fp, Gll^Fp, Gg^Fet, Gll, Gg, Gg^Efm, Mm, Hh, Hh^Vhh, Mm, Mm, Mm, Mm, Mm^Xm, Mm^Xm
Gs, Ww, Gll^Edb, Wwf^Em, Gll^Fp, Ds, Gll^Fp, Gll^Fp, Gll^Fp, Gll^Fp, Gg^Fet, Rb, Rb, Rb, Gll^Vl, Gll^Fp, Gll^Fp, Gll^Fp, Gll, Mm, Mm, Hh, Hh, Mm, Mm, Mm, Mm^Xm, Mm^Xm, Mm^Xm
Gd, Gd, Gd, Gll^Fp, Gll^Fp, Gll^Fp, Gll^Fp, Gll^Fp, Gll^Fp, Gll^Fp, Gll^Fp, Gll^Fp, Gs^Fp, Gll^Fp, Gg, Gll^Fp, Gll^Fp, Gll^Fp, Gg, Gg^Efm, Mm, Hh, Hh, Mm, Mm, Mm, Mm^Xm, Mm^Xm, Mm^Xm
