Wo, Wo, Wo, Wo, Wo, Wo, Wo, Wo, Wo, Wo, Wo, Wo, Wo, Wo, Wo, Wo, Wwt, Ds, Hd, Hd, Hd, Hd, Hd, Hd, Hd, Hd, Hd, Hd, Hd, Hd, Hd, Hd, Hd, Dd, Dd, Dd, Dd, Dd, Dd, Dd, Dd, Dd, Dd, Dd, Dd, Dd, Dd, Dd, Dd, Dd, Md, Md, Md, Md, Md, Md, Md
Wo, Wo, Wo, Wo, Wo, Wo, Wo, Wo, Wo, Wo, Wo, Wo, Wo, Wo, Wo, Wo, Wwt, Ds, Ds, Dd^Vdt, Hd, Hd, Hd, Hd, Hd, Hd, Wwt, Hd, Hd, Hd, Hd, Hd, Dd, Dd, Ds, Ds, Ds, Dd, Ds, Dd, Dd, Dd, Dd, Dd, Hd, Hd, Wwt, Hd, Dd, Dd^Vda, Dd, Hd, Hd, Hd, Hd, Md, Md
Wo, Wo, Wo, Wo, Wo, Wo, Wo, Wo, Wo, Wo, Wwt, Wo, Wwt, Wo, Wwt, Wwt, Wwt, Wwt, Wwf, Hd, Hd, Hd, Dd^Do, Hd, Hd, Hd, Hd, Hd, Dd, Dd^Vda, Dd, Dd, Wwt, Wwt, Wwt, Wwt, Wwt, Ds, Wwt, Ds, Ds, Dd^Vdt, Ds, Dd, Dd, Dd, Dd, Dd, Ds, Dd, Dd, Dd, Dd, Dd, Hd, Hd, Md
Wo, Wo, Wo, Wo, Wo, Wo, Wwrt, Wwrt, Wwrt, Wwt, Wwt, Wwt, Ds, Wwt, Wwt, Wwt, Wwt, Wwt, Wwt, Wwf, Dd, Dd, Dd, Gs, Dd, Hd, Dd, Dd, Wwt, Dd^Do, Wwt, Wwt, Wwt, Wwt, Wwt, Wwt, Wwt, Wwt, Wwt, Wwf, Wwf, Ds, Ds, Ds, Ds, Dd, Ds, Ds, Ds, Ds, Dd, Dd, Dd^Dc, Dd, Dd, Dd, Ds
Wo, Wo, Wo, Wo, Wo, Wo, Wo, Wwrt, Wwt, Wwt, Wwt, Wwt, Ds, Ds, Dd, Wwf, Wwf, Wwt, Wwt, Wwt, Wwt, Wwt, Wwt, Wwt, Wwt, Dd, Dd, Wwt, Wwt, Wwt, Wwt, Wwt, Wwt, Wwt, Wwt, Wwt, Wwrt, Wwt, Wwf, Wwf, Wwf, Wwt, Wwt, Wwt, Wwt, Ds, Ds, Ds, Ds, Ds, Dd, Dd, Dd, Dd, Ds, Dd^Vdt, Dd
Wo, Wo, Wo, Wo, Wo, Wo, Wo, Wwrt, Wwt, Wwt, Wwt, Wwt, Dd, Hd, Dd, Dd, Ds, Wwt, Wwt, Wwt, Wwt, Wwt, Wwt, Wwt, Wwt, Wwt, Wwf, Wwf, Wwf, Wwt, Wwt, Wwt, Wwt, Wwt, Wwt, Wwt, Wwrt, Wwrt, Wwrt, Wwrt, Wwt, Wwt, Wwt, Wwt, Wwt, Wwt, Ds^Dr, Ds, Ds, Ds, Dd, Dd, Dd, Dd, Gs, Hd, Dd
Wo, Wo, Wo, Wo, Wo, Wo, Wo, Wwrt, Wwt, Wwt, Ds, Ds, Md, Dd^Do, Gs, Gs, Ds, Wwt, Wwt, Wwt, Wwt, Wwf, Wwf, Wwt, Wwt, Wwt, Wwf, Wwf, Wwf, Wwt, Wwt, Wwt^Vm, Wwt, Wwt^Vm, Wwt, Wwt, Wwt, Wwt, Wwt, Wwrt, Ds, Wwt, Wwt, Wwt, Wwt, Wwt, Wwt, Ds, Ds, Dd, Wwt, Wwt, Gs, Dd, Md, Dd^Do, Dd
Wo, Wo, Wo, Wo, Wo, Wo, Wwrt, Wwrt, Wwt, Wwt, Dd, Hd, Md, Md, Dd, Dd, Dd, Wwt, Wwt, Wwrt, Wwrt, Wwt, Wwt, Wwt, Wwt, Wwt, Wwt, Wwf, Wwf, Wwt, Wwt, Wwt, Wwt, Wwt, Wwt, Wwt, Wwf, Wwt, Wwt, Wwt, Ds, Ds, Wwt, Wwf, Wwf, Wwt, Wwt, Ds, Dd, Ds, Wwt, Wwt, Wwt, Hd, Md, Md, Dd
Wo, Wo, Wo, Wo, Wwrt, Wwrt, Wwt^Vm, Wwt, Wwt, Ds, Dd, Md, Md, Md, Md, Wwt, Wwt^Bw|, Ds, Wwt, Wwt, Wwrt, Wwt, Ds, Wwf, Wwf, Wwt, Wwt, Wwt, Wwt, Wwt, Ds, Ds, Wwt, Wwt, Wwt, Wwt, Wwf, Wwf, Wwt, Wwt, Wwt, Wwt, Wwt, Wwt, Wwf, Wwf, Wwf, Ds, Gg, Ds, Dd^Vda, Gs^Ft, Ds, Hd, Dd, Hd, Md
Wo, Wo, Wo, Wo, Wo, Wwrt, Wwt, Wwt, Wwt, Ds, Hd, Md, Md, Hd, Dd, Dd, Dd, Wwt, Wwt, Wwrt, Wwt, Ds, Ds, Wwf, Wwf, Wwf, Wwt^Vm, Wwt, Ds, Ds^Ewsh, Wwf, Ds^Ewsh, Wwt, Cm, Cm, Wwt, Wwt, Wwt, Wwt^Vm, Wwt, Wwt, Wwt, Wwt, Wwt, Wwt, Wwf, Wwf, Gg, Gs, Ds, Gg, Ds, Ds, Dd, Md, Hd, Dd
Wo, Wo, Wo, Wo, Wo, Wo, Wo, Wwt, Wwt, Ds, Hd, Md, Hd, Hd, Dd, Dd^Do, Dd, Wwt, Wwt, Wwrt, Wwt, Wwt, Wwt, Wwf, Wwt, Wwt, Wwt, Wwt, Wwt, Ds, Ds, Wwt, Wwt, Km, Wwt, Wwt, Wwt, Wwt, Wwt, Wwt, Wwt, Wwt, Wwt, Wwt, Wwt, Wwt, Wwt, Ds, Ds, Gs, Ds, Gg, Ds, Hd, Hd, Hd, Dd
Wo, Wo, Wo, Wo, Wo, Wo, Wwt, Wwt, Gg, Dd, Rd, Dd, Dd, Dd, Gs, Dd^Vdt, Ds, Wwt, Wwf, Wwrt, Wwt, Wwt, Wwt, Wwt, Wwt, Wwt, Wwt, Wwt, Wwt, Wwt, Ds, Ds, Ds, Wwt, Wwt, Wwt, Wwt, Wwt, Wwt, Wwt, Wwt, Wwt, Wwt, Wwt, Wwt, Wwt, Wwt, Ds, Ds, Gs, Gs, Gs, Ds, Ds, Gs^Ft, Dd, Gs
Wo, Wo, Wo, Wo, Wo, Wwrt, Wwrt, Wwt, Wwt, Ce, 3 Ke, Ce, Wwt, Gs, Gs, Gs, Ds, Ds, Wwt, Wwt, Wwt, Wwt, Wwt, Wwt, Wwt, Wwt, Wwt, Wwt, Wwt, Wwt, Wwt, Wwt, Wwt, Wwt, Wwt, Wwt, Wwt, Wwt, Wwrt, Wwt, Wwt, Wwt, Wwf, Wwf, Wwf, Wwt, Wwf, Ds, Ds, Ds, Ds, Gs, Ds, Ds, Gs^Ft, Gs^Ft, Hh
Wo, Wo, Wo, Wo, Wo, Wwrt, Wwt, Wwt, Wwt, Wwt, Ce, Ce, Gs^Ft, Wwt, Wwt, Gg, Gg, Ds, Wwt, Wwt, Wwt, Wwt, Wwt, Wwt, Wwrt, Wwrt, Wwrt, Wwt, Wwt, Wwt, Wwt, Wwt^Vm, Wwt, Wwt^Vm, Wwt, Wwt, Wwr, Wwrt, Wwrt, Wwrt, Wwrt, Wwf, Wwf, Wwf, Ss^Vm, Wwf, Gg, Gs, Gs, Gs, Gs, Gs^Ft, Gs, Gs, Ss^Vhs, Hh, Hh
Wo, Wo, Wo, Wo, Wo, Wwrt, Wwt, Wwt, Wwt, Wwt, Gg, Gg, Gs^Ft, Gs^Ft, Gs, Wwt, Wwt, Wwt, Ds, Wwt, Wwt, Wwt, Wwt, Wwt, Wwt, Wwrt, Wwt, Wwt, Wwt, Wwt, Wwf, Wwf, Wwf, Wwt, Wwt, Wwt, Wwt, Wwt, Wwt, Wwf, Wwf, Wwf, Wwf, Wwf, Ss, Ss, Gg^Efm, Gg, Gg, Gg, Hh^Fms, Gs, Hh, Hh, Mm, Mm, Mm
Wo, Wo, Wo, Wo, Wo, Wo, Wo, Wwt, Wwt, Wwt, Gg, Gs^Ft, Gs^Ft, Gs^Ft, Gs, Gg, Wwt, Gg, Gs, Ds, Wwt, Wwt, Wwt, Wwt, Wwrt, Wwrt, Wwrt, Wwrt, Wwf, Wwf, Wwt, Wwt, Wwt, Wwt, Wwt, Wwt, Wwt, Wwt, Wwf, Wwt, Wwt, Wwf, Wwf, Ss, Ss, Gg^Efm, Gg, Gg^Efm, Hh, Hh^Fp, Hh, Hh, Wwt, Hh, Mm, Mm, Mm
Wo, Wo, Wo, Wo, Wo, Wo, Wwt, Wwt, Wwt, Wwt, Gs^Ft, Gs^Ft, Gs^Ft, Gs^Ft, Gs^Ft, Gs, Ss, Gs, Gs, Ds, Wwt, Wwt^Vm, Wwt, Ww, Wwf, Wwrt, Wwt, Wwt, Wwt, Wwf, Wwt, Wwt, Wwt, Ds, Ds, Ds, Wwt, Wwf, Wwf, Wwf, Wwf, Wwt, Wwt, Wwt, Wwt, Gg^Efm, Gg, Gg^Vc, Hh, Hh, Wwt, Wwt, Hh, Wwt, Mm, Mm, Mm
Wo, Wo, Wo, Wo, Wwrt, Wwt^Vm, Wwt, Wwt, Wwt, Wwt, Gs^Ft, Gg, Gs^Ft, Gs^Ft, Gs^Ft, Ss, Gs^Ft, Gs, Gs^Ft, Gs^Ft, Gs, Wwt, Wwf, Wwf, Wwf, Wwt, Wwt, Wwt, Wwt, Wwf, Wwt, Wwt, Wwt, Ds, Wwt, Wwt, Wwt, Wwt, Wwt, Wwt, Ds, Wwf, Ss, Ss, Gg, Wwt, Wwt, Wwt, Wwt^Bw|, Wwt, Hh, Hh, Hh, Mm, Mm, Mm, Mm
Wo, Wo, Wwrt, Wwrt, Wwrt, Wwt^Vm, Wwrt, Wwt, Wwt, Wwt, Ss, Gg, Ss, Gs^Ft, Wwt, Ss, Gs^Ft, Gs^Ft, Gs^Ft, Gs^Ft, Gs, Gs, Gs^Ft, Wwf, Wwf, Wwf, Wwf, Wwf, Wwt, Wwt, Wwt, Wwt, Wwt, Wwt, Wwt, Wwt, Wwt, Wwt, Wwt, Ss, Gg, Gg, Gg, Gg, Hh, Hh^Fp, Hh, Gg^Efm, Hh, Hh, Hh^Fp, Hh, Hh, Mm, Mm, Mm, Mm
Wo, Wo, Wwt, Wwt, Wwt, Wwrt, Wwrt, Wwt, Wwt, Ss, Ss, Ss, Ss, Ss, Ss^Vhs, Ss, Ss, Gs, Ss, Ss, Ss, Gs^Ft, Gs^Ft, Gs, Gs, Wwf, Ds, Wwf, Wwt, Wwt, Ds, Wwt, Wwt, Wwt, Wwt, Wwt, Wwt, Wwt, Wwt, Ss, Ss, Hh, Hh, Hh, Hh^Fp, Hh^Fms, Hh, Hh, Hh, Hh^Fp, Hh^Fms, Hh, Mm, Mm, Mm, Hhd^Vhhr, Mm
Wo, Wwt, Mm, Mm, Mm, Wwt, Wwrt, Wwt, Ss, Ss, Ss, Ss, Ss, Ss, Ss, Ss, Gs^Ft, Ss, Ss, Ss, Ss, Gs^Ft, Gs, Gs^Ft, Ss, Gs, Gs, Ds, Dd, Ds, Dd, Ds, Ds, Ds, Ds, Ds, Ss, Wwt, Wwt, Wwt, Wwt, Ss, Hh, Hh^Fp, Hh, Hh, Wwt, Ss^Vm, Hh, Hh^Fp, Hh, Hh, Hh, Mm, Mm^Xm, Mm, Mm
Wo, Wwt, Wwt, Mm, Wwt, Wwt, Wwrt, Wwt, Wwt, Ss, Ss, Ss, Ss, Ss, Ss, Ss, Ss, Cme, Ss, Ss, Ss, Gs, Gs, Gs^Ft, Ss, Ss, Gg, Gg, Gg^Efm, Dd, Dd^Do, Dd, Gs, Ds, Co, Gs, Ss, Ss, Ss, Ss, Ss, Wwt, Wwt, Gg, Wwt, Gg^Efm, Wwt, Wwt, Wwt, Hh, Hh, Hh, Mm, Mm, Mm, Mm, Mm
Wo, Wo, Wwrt, Wwt, Wwrt, Wwrt, Wwt, Wwt, Ss, Wwt, Wwt, Wwt, Wwt, Ss, Ss, Ss, Ss, Ss, Ss, Ss, Ss^Vhs, Ss, Ss, Ss, Ss, Ss, Gs^Ft, Gs^Ft, Ss, Ss, Gs^Ft, Gg, Gs^Ft, Co, 2 Ko, Gg^Efm, Gg^Efm, Ss, Ss, Ss^Vm, Ss, Ss, Ss, Wwt, Ss, Wwt, Ss, Ss, Hh, Wwt, Hh, Mm, Mm, Mm, Mm, Mm, Mm
Wo, Wo, Wwrt, Wwrt, Wwt, Wwrt, Wwt, Ss, Ss, Ss, Wwt, Ss, Ss, Ss, Gs^Ft, Cme^Dr, Cme, Ss, Ss, Ss, Ss, Ss, Ss^Vhs, Ss, Ss, Ss, Ss, Ss^Vm, Ss, Gs^Ft, Gs^Ft, Gs^Ft, Gs^Ft, Gs^Ft, Co, Co, Gs, Gg^Efm, Gg^Efm, Ss, Hh, Hh, Gg^Efm, Wwt, Ss, Cud, Cud, Cud, Gg, Wwt, Wwt, Mm, Mm^Xm, Mm, Mm, Mm, Mm
Wo, Wo, Wo, Wo, Wwt, Wwt, Wwt, Wwt, Ss, Ss, Wwt, Ss, Ss, Ss, Ss, Cme, 4 Kme, Cme, Ss, Ss, Ss, Ss, Ss, Ss, Ss, Ss, Ss, Ss, Ss, Gs^Ft, Gs^Ft, Gs^Ft, Gs, Gs, Gs^Ft, Wwt, Wwt, Gs, Gg, Hh^Fp, Hh, Gg, Wwt, Wwt, Gg, Cud, Qxe, 1 Kud, Hh, Mm, Mm, Mm, Mm, Mm, Hhd^Vhhr, Mm, Mm^Xm
Wo, Wo, Wo, Wo, Wwt, Wwt, Wwt, Wwt, Ss, Ss, Ss, Wwt, Wwt, Wwt, Ss, Ss, Cme, Cme, Ss, Ss, Ss, Ss, Ss, Ss, Wwt, Wwt^Vm, Ss, Ss, Gs^Ft, Gs, Gs, Gs, Ss, Gs^Ft, Gs^Ft, Wwt, Wwt, Wwt, Wwt, Gg, Wwt, Gs, Wwt, Gg, Hh, Gg, Hh, Hh, Hh^Fp, Mm, Mm, Mm, Ha, Mm, Md, Mm, Mm^Xm
Wo, Wo, Wwt, Wwt, Wwt, Wwt, Wwt, Ss, Wwt, Wwt, Wwt, Ss, Ss, Ss, Ss, Ss, Ss, Ss, Ss, Ss, Ss, Ss, Ss, Ss, Ss, Ss, Gs^Ft, Gs^Ft, Gs^Ft, Gs^Ft, Gs, Gs^Vht, Ss, Ss, Gs^Ft, Wwt, Wwt, Wwt, Hh, Wwt, Wwt, Wwt, Hh, Hh, Mm, Hh^Fp, Mm, Hh^Fp, Mm, Mm, Mm, Mm, Mm^Xm, Mm^Xm, Mm^Xm, Mm^Xm, Mm^Xm
Wo, Wo, Wo, Wwt, Wwt, Wwt, Wwt, Ss, Ss, Wwt, Ss, Ss, Ss, Ss, Wwt, Wwt, Wwt, Ss^Vhs, Ss, Ss, Ss, Ss, Cme, Cme, Ss, Ss, Gs^Ft, Gs^Ft, Gs^Ft, Gs^Ft, Gs, Gs^Ft, Gs^Ft, Gs^Ft, Gs^Ft, Gs^Ft, Gs^Ft, Gs, Wwf, Ww^Vm, Mm, Wwt, Mm, Mm, Mm, Mm, Mm^Xm, Mm, Mm, Mm, Mm, Mm, Mm^Xm, Mm^Xm, Mm^Xm, Mm^Xm, Mm^Xm
Wo, Wo, Wwt, Wwt, Wwt, Wwt, Wwt, Ss, Ss, Ss, Ss, Ss, Gs^Ft, Ss, Ss, Wwt, Ss, Ss, Ss, Ss, Ss, Gs^Ft, Gs^Ft, Gs^Ft, Gs^Ft, Gs^Ft, Gs^Ft, Gs^Ft, Gs^Ft, Gs^Ft, Gs^Ft, Gs^Ft, Gs^Ft, Gs^Ft, Gs^Ft, Gs^Ft, Gs^Ft, Gs^Ft, Gs, Mm, Mm, Mm^Xm, Mm, Mm^Xm, Mm^Xm, Mm^Xm, Mm^Xm, Mm^Xm, Mm, Mm, Mm, Mm, Mm^Xm, Mm^Xm, Md, Mm^Xm, Ms
Ww, Wo, Wo, Wwt, Wwt, Wwt, Wwt, Gg, Gg, Ss, Gg, Gs^Ft, Gs^Ft, Gs^Ft, Gg, Gs^Ft, Gg, Gs^Ft, Gg, Gs^Ft, Gg, Gs^Ft, Gg, Gs^Ft, Gs^Ft, Gs^Ft, Gs^Ft, Gs^Ft, Gs^Ft, Gs^Ft, Gs^Ft, Gs^Ft, Gs^Ft, Gs^Ft, Gg, Gs^Ft, Gg, Gs^Fp, Gs^Fp, Gs^Fp, Hh, Mm, Mm, Mm, Mm, Mm, Md, Md, Md, Mm, Mm, Mm, Mm, Md, Md, Md, Mm^Xm
