Rra, Aa^Fpa, Aa^Fpa, Aa^Fpa, Aa^Fpa, Aa^Fpa, Aa^Fpa, Aa^Fpa, Aa^Fpa, Aa^Fpa, Ha, Ha, Ha, Ha, Ha, Ha, Ha, Ha, Ha, Ha, Ha, Ha, Ha, Ha, Aa, Aa, Aa, Aa, Aa, Aa, Ha, Ha
Rra, Rra, Aa^Fpa, Aa^Fpa, Aa^Fpa, Aa^Fpa, Aa^Fpa, Aa^Fpa, Ha, Aa^Fpa, Ha, Ha, Ha, Ha, Ha, Ha, Ha, Ha, Ha, Ha, Ha, Ha, Ha, Ha, Aa, Aa, Aa, Aa, Aa, Aa, Ha, Ha
Aa^Fpa, Rra, Rra, Cea, Aa, Aa^Fpa, Aa^Fpa, Ha, Ha, Ha, Ha^Vhha, Ha, Ha, Ms, Ms, Ha, Ha, Ha, Ha^Vhha, Ha, Ha, Ha, Aa, Ha, Aa, Aa, Cte, Cte, Cte, Ha, Ha, Ha
Aa^Fpa, Aa^Fpa, Cea, Rra, Aa, Aa, Aa^Fpa, Aa^Fpa, Ha, Ha, Ha, Ha, Ha, Ms, Ha, Ha, Ha, Ha, Ha, Ha, Ha, Ha, Ha, Aa^Voa, Aa, Aa, Cte, 3 Kte, Cte, Ha, Ms, Ha
Aa^Fpa, Aa^Fpa, Aa, Rra, Rra, Aa, Aa, Aa^Fpa, Aa^Fpa, Ha, Ha, Ha, Aa^Fpa, Ha, Ha, Ha, Ha, Ha, Ha, Ha, Ha, Ha, Ha, Aa, Aa, Aa, Aa, Cte, Aa, Ha, Ms, Ha
Aa^Fpa, Aa^Fpa, Aa^Fpa, Aa^Fpa, Aa, Rra, Rra, Aa, Aa^Fpa, Aa^Fpa, Aa^Fpa, Aa^Fpa, Aa^Fpa, Ha, Ha, Ha, Aa^Fpa, Ha, Hh^Fpa, Ha, Ha, Ha, Aa, Aa, Aa, Aa, Aa, Aa, Ha, Ha, Ms, Ha
Aa^Fpa, Aa^Fpa, Gg^Fpa, Gll^Fpa, Aa, Rra, Rra, Aa, Aa, Aa^Fpa, Aa, Aa^Fpa, Aa, Aa^Fpa, Aa^Fpa, Aa^Fpa, Aa^Fpa, Hh^Fpa, Gll^Fpa, Gll^Fpa, Aa, Aa, Aa, Aa, Aa, Aa^Voa, Ha, Ha, Ha, Ha, Ms, Ms
Aa^Fpa, Aa^Fpa, Gg^Fpa, Gg^Fpa, Aa, Aa, Aa, Rra, Rra, Aa, Aa, Aa, Aa, Aa, Aa^Fpa, Aa, Ha, Ha, Ha, Aa, Aa^Vaa, Aa, Aa, Aa, Aa, Aa, Ha, Ha, Ha, Ha, Ha, Ha
Aa^Fpa, Aa^Fpa, Ha^Fpa, Gg^Fpa, Ha, Aa, Aa, Aa, Aa, Rra, Aa, Aa, Aa, Aa, Aa, Aa, Ha, Ha, Aa, Aa, Aa, Aa, Aa, Aa, Aa, Aa, Ha, Ha, Ai, Ha, Ai, Ai
Aa^Fpa, Aa^Fpa, Ha^Fpa, Ha^Fpa, Ha, Ha, Ha, Aa, Aa, Rra, Rra, Aa^Voa, Aa, Aa, Aa, Aa^Voa, Aa, Ha, Ha, Aa, Aa, Aa^Fpa, Aa^Fpa, Aa^Fpa, Aa^Fpa, Aa, Ai, Ai, Aa^Vea, Ai, Ai, Ai
Ha, Ha^Fpa, Ha^Fpa, Ha, Ha, Ha^Vhha, Ha, Ha, Ha, Aa, Rra, Aa, Aa, Aa, Ha, Aa, Ha, Ha, Ha, Ha, Ha, Ha, Ha, Ha, Ai, Ai, Aa^Fpa, Aa^Fpa, Aa^Fpa, Aa^Fpa, Aa^Fpa, Aa^Fpa
Ha, Ha^Fpa, Ha^Fpa, Ha, Ms, Ha, Ha, Ha, Ha, Ha, Aa, Rra, Ha, Ha, Ha, Ha, Ha, Ha, Ha, Ha, Ha, Ha, Ha, Ha, Ai, Aa^Fpa, Aa^Fpa, Aa^Feta, Aa^Fpa, Aa^Fpa, Aa^Fpa, Aa^Fpa
Ha, Ha, Ha, Ha, Ms, Ha, Ha, Ha, Ha, Ha, Aa, Rra, Ha, Ha, Ha, Ha, Ha, Ha, Ha, Ha, Ha, Ha^Vhha, Ha, Ha, Ha, Ai, Aa^Fpa, Aa^Fpa, Aa^Fpa, Aa^Vea, Aa^Fpa, Aa^Fpa
Ha, Ha, Ha, Ms, Ha^Vhha, Ha, Ha, Ha, Ha, Ha, Aa, Rra, Aa, Ha, Ha, Ha, Ha, Ha^Voa, Ha, Ha, Ha, Ha, Ha, Ha, Ha, Ai, Ai, Ai, Aa^Fpa, Aa^Fpa, Aa^Fpa, Aa^Fpa
Ha, Ha, Ms, Ms, Ha, Ha, Ha, Ha, Aa, Aa, Aa^Voa, Rra, Aa, Aa, Coa, Coa, Coa, Ha, Ha, Ha, Ha, Ha, Ha, Ha, Ai, Ai, Aa^Fpa, Aa^Fpa, Aa^Fpa, Aa^Fpa, Aa^Fpa, Aa^Fpa
Ha, Ha, Ha, Ms, Ha, Ha, Ha, Ha, Aa, Aa, Aa, Rra, Aa, Aa, Coa, 2 Koa, Coa, Ha, Ha, Ha, Ha, Ha, Ha, Ai, Aa^Fpa, Aa^Fpa, Aa^Fpa, Aa^Fpa, Aa^Fpa, Aa^Fpa, Aa^Fpa, Aa^Fpa
Ha, Ms, Ha, Ms, Ha, Ha, Ha, Ha, Ha, Aa, Aa, Rra, Ha, Aa, Ha, Coa, Ha, Ha, Ha^Vhha, Ha, Ha, Ha, Ha, Ai, Aa^Fpa, Aa^Fpa, Aa^Fpa, Ss, Aa^Fpa, Aa^Fpa, Aa^Feta, Aa^Fpa
Ha, Ms, Ms, Ha, Ha, Ha, Ha, Ha, Aa, Aa, Aa, Rra, Ha, Ha, Ha, Ha, Ha, Ha, Ha, Ha, Ha, Ha, Ai, Ai, Aa^Fpa, Aa^Fpa, Aa^Fpa, Aa^Fpa, Aa^Fpa, Aa^Fpa, Aa^Fpa, Aa^Fpa
Ha, Ha, Ms, Ha, Ha, Ha, Ha, Ha, Ha, Aa, Rra, Rra, Ha, Ha, Ha^Voa, Ha, Ha, Ha, Ha, Ha, Ai, Ai, Aa^Fpa, Aa^Feta, Aa^Fpa, Aa^Vea, Aa^Fpa, Aa^Fpa, Aa^Vea, Aa^Fpa, Aa^Fpa, Aa^Fpa
Ha, Ha, Ha, Ms, Ms, Ha, Ha, Ha, Ha, Aa, Rra, Ha, Ha, Ha, Ha, Ha, Ha, Ha, Ha, Ha, Ai, Aa^Fpa, Aa^Fpa, Aa^Fpa, Aa^Fpa, Aa^Fpa, Aa^Fpa, Aa^Fpa, Aa, Aa^Fpa, Aa^Fpa, Aa^Fpa
Ha, Ha, Ha, Ms, Ha, Ha, Ha, Hh^Fp, Gll^Fp, Cea, Rra, Cea, Gg, Gg, Gs, Hh, Hh, Gll^Fp, Gll^Fp, Ai, Gg, Gg^Efm, Gg^Efm, Aa^Fpa, Aa^Fpa, Aa, Cva, Cva, Aa, Aa^Fpa, Aa^Fpa, Aa^Fpa
Ha, Ha, Ha, Ha, Ha, Ha, Hh^Fp, Hh^Fp, Gll^Fp, Gll^Fp, Rra, Gg, Gg, Gg, Gll, Gs, Gll^Fp, Gll^Fp, Ww, Ai, Gg, Gg, Gll, Gll^Em, Aa^Fpa, Aa^Fpa, Cva, 4 Kva, Aa^Fpa, Aa^Vea, Aa^Fpa, Aa^Fpa
Gll^Fp, Gll^Fp, Gll^Fp, Ha, Gll^Fp, Gll^Fp, Gll^Fp, Gll^Fp, Gll^Fp, Gll^Fp, Rr, Gg, Gll, Gll, Gll^Fp, Gll^Fp, Gll^Fp, Gll^Fp, Ww, Gg, Gg, Gg^Vc, Gg, Gll, Aa^Fpa, Aa^Fpa, Aa^Fpa, Cva, Aa^Feta, Aa^Fpa, Hh^Fp, Aa^Fpa
Gll^Fp, Gll^Fp, Gll^Vc, Gll^Fp, Gll^Fp, Gll^Fp, Gll^Fp, Gll^Fp, Gg, Gg, Rr, Gg, Gg, Gll, Gll^Fp, Gll^Fp, Ww^Bw\, Ww, Gg^Efm, Gg^Efm, Gs^Efm, Gg, Gs, Gs^Fp, Aa^Fpa, Aa^Fpa, Aa^Fpa, Aa^Fpa, Aa^Fpa, Aa^Fpa, Hh^Fp, Hh^Fp
Gll^Fp, Gll^Fp, Gll, Gll^Fp, Gs, Gll^Fp, Gs^Efm, Gg^Efm, Rr, Rr, Gg^Efm, Gg^Efm, Gll^Fp, Gll^Fp, Gll^Fp, Gll^Ve, Ww, Gg^Efm, Gg^Efm, Gg^Efm, Gs, Gs, Gs, Gg, Gg, Gg, Gg, Gg, Gg, Hh, Hh^Fp, Hh^Fp
Gg, Gll, Gg, Gs, Gs, Gs^Efm, Rr, Rr, Gg, Gg^Efm, Gg, Gg, Gll^Fp, Gll^Fp, Ww, Ww, Ww, Ds, Gg^Efm, Gg^Efm, Gs^Efm, Gg, Gg^Vc, Gg, Gg, Gg, Gg, Gg, Hh, Hh, Mm, Mm
Gg, Gll, Gg, Gg, Gs, Gg, Rr, Rr, Gg, Gg, Gll^Fp, Gll^Fp, Ds, Ds, Ww, Ww, Ww, Ww, Ww, Gg^Efm, Ds, Gg, Gg, Gg, Gg, Gg, Gg, Hh, Hh^Vc, Mm, Mm, Mm
Gg, Gg, Gg, Ce, Ce, Ce, Gg, Gg, Gg, Gg, Gg, Gll^Fp, Ww, Ww, Ww, Ww, Ww, Ww, Ww, Ww, Ww, Ds, Gg, Gg, Gg, Gs, Hh, Hh, Mm, Mm, Mm, Mm
Gg, Gg, Gg, Ce, 1 Ke, Ce, Rr, Gg, Gg, Gg^Vc, Rr, Ds, Ww, Ww, Ww, Ww, Ww, Ww, Ww, Ww, Ds, Ds, Gs, Gg, Hh, Hh, Md, Md, Mm, Mm, Mm, Mm
Gg, Gg, Gg, Ce, Ce, Ce, Gg, Rr, Rr, Rr, Ds, Ww^Bw\, Ww, Ww, Ww, Ds, Ds, Ww, Ww, Ww, Ww, Ds, Hh, Hh, Mm, Md, Md, Md, Mm, Mm, Mm, Mm
Gg, Gg^Vc, Rr, Rr, Gg^Efm, Gs, Gs^Efm, Gg, Ds, Ds, Ww, Ww^Es, Ww, Ww, Ww, Gg, Gg, Ww, Gg, Ww, Gg, Gg, Hh, Mm^Vc, Mm, Mm, Mm, Mm, Mm, Mm^Vc, Mm, Mm
Gg, Gg, Rr, Gg, Gg^Efm, Gs, Gg^Efm, Gg, Ds, Ds, Ww, Ww, Ww, Ww, Ww, Gg, Ss, Ss, Ss, Ss, Ss, Gg, Hh, Mm, Mm, Mm, Mm, Mm, Mm, Mm, Mm, Mm
