Mm, Mm^Vhh, Mm, Mm, Hh, Gg, Gll, Gll^Fp, Gg^Fet, Gll^Fp, Gll^Fp, Gll^Fp, Ds, Ds, Ww, Cv, Cv, Cv, Cv, Cv, Ww, Gll^Fp, Ww, Ds, Ds, Ds, Ww
Mm, Mm, Hh, Hh, Hh, Gg, Ds, Gll^Fp, Gll^Fp, Gll^Fp, Ww, Ww, Ww, Ww, Ww, Ww, Ww, Cv, Ww, Ww, Ww, Ww, Ww, Ww, Ww, Ww, Ww
Hh, Mm, Hh, Hh, Ds, Ds, Ww, Ds, Ww, Ds, Ww, Ww, Wo, Ww, Wo, Ww, Wo, Ww, Wo, Ww, Wo, Wo, Wo, Ww, Wo, Wo, Wo
Ww, Hh, Hh, Ds, Ww, Ds, Ww, Ww, Wo, Ww, Wo, Wo, Wo, Wo, Wo, Wo, Wo, Wo, Wo, Wo, Wo, Wo, Wo, Wo, Wo, Wo, Wo
Ww, Ww, Ww, Ww, Ww, 4 Ww, Wo, Wwr, Wo, Wo, Wo, Wo, Wo, Wo, Wo, Wo, Wo, Wo, Wo, Wo, Wo, Wo, Wo, Wo, Wwr, Wo, Wo
Wo, Wo, Wo, Wo, Wo, Wo, Wo, Wo, Wo, Wo, Wo, Wo, Wo, Wo, Wwt, Wwt, Wwt, Wwt, Wwt, Wwt, Wwg, Wwt, Wwt, Wwt, Wwg, Wwt, Wwt
Wo, Wo, Wo, Wo, Wo, Wo, Wo, Wo, Wwt, Wo, Wwg, Wwt, Wwr, Wwt, Wwt, Wwt, Wwt, Wwg, Wwg, Wwr, Wwt, Wwg, Wwg, Wwg, Wwt, Wwg, Wwg
Wwt, Wo, Wwt, Wwt, Wwt, Wwt, Wwg, Wwt, Wwg^Bw|, Wwg, Wwg, Wwg, Wwg, Wwg, Wwg, Wwg, Wwg, Wwg, Wwg, Wwg, Wwg, Wwg, Wwg, Wwg, Wwf, Wwt, Wwf
Wwt, Wwt, Wwf, Wwt, Wwg, Wwg, Wwg, Wwg, Wwf^Bw|, Wwf, Wwf, Wwg, Wwf, Wwg, Wwg, Wwg, Wwf^Bw|, Wwg, Wwf, Wwf, Wwf, Wwf, Wwf, Wwf, Ww^Ewl, Wwf, Wwf
Wwf, Wwf, Wwf, Ww^Ewl, Wwf, Wwg, Wwg, Wwg, Wwf^Bw|, Ww^Ewl, Wwf, Wwf, Wwf, Wwf, Wwf, Wwf, Gs^Vh, Wwf, Gg, Wwf, Wwf^Bw|, Wwf, Wwf, Wwf, Gg, Wwf, Wwf
Wwf, Wwf, Wwf, Wwf, Wwf, Wwf, Wwf, Wwf, Gs^Vh, Wwf, Gll^Efm, Gs^Vh, Ce, Ce, Ke, Gg, Gll^Fp, Gg, Gs^Fds, Gg, Gg, Gs^Vh, Gg, Gg, Gg, Gg, Hh
Gg, Wwf, Gg, Gs^Vh, Gs, Gg, Ch, Gg, Gg, Re, Re, Re, Re, Gg^Fet, Re, Gg^Fet, Gs^Fds, Gs^Fds, Gll^Fp, Gs^Fds, Gs^Fds, Hh, Hh, Hh, Hh, Hh, Hh
Hh^Fp, Gg, Gg, Gg, Gg, Gg, Ch, 3 Kh, Re, Re, Gs^Fds, Gs^Fds, Gs^Fds, Re, Re, Gs^Fds, Gg^Fet, Gs^Fms, Gs^Fds, Gs^Fds, Gll^Fp, Gs^Fds, Hh, Hh^Vhh, Hh, Hh, Hh
Mm, Hh^Fp, 1 Re, Re, Re, Re, Gg, Ch, Gg, Gg^Fet, Gg, Gll^Fp, Gg^Ve, Gs^Fds, Gs^Fds, Re, Gll^Fp, Gs^Fms, Gs^Fds, Gs^Fds, Gg^Fet, Gs^Fds, Hh, Hh, Hh, Hh^Vhh, Hh
Re, Re, Hh, Hh, Gg, Gll^Fp, Gg, Gg, Gg, Gg, Gg, Gg, Gg, Gll^Fp, Gg, Re, Re, Gg, Re, Gs^Fds, Gll^Fp, Gs^Fds, Hh, Hh, Hh, Hh, Hh
Mm, Mm, Mm, Hh, Gg, Gg, Gg, Gs^Vc, Gg, Gg, Gg, Gg, Gg, Gg, Gs^Vc, Gg, Gg, Re, Re, Re, Re, Gg, Re, Hh, Hh, Hh^Vhh, Hh
Mm, Mm, Mm, Hh, Gg, Gg, Gg, Gg, Gll^Fp, Gg, Gs^Fds, Gs^Fds, Gs^Fds, Gg, Gg, Re, Re, Gg, Re, Gs^Vc, Gs^Fds, Re, Gll^Fp, Re, Re, Re, Re
Mm, Mm, Mm, Mm^Vhh, Gg, Gg, Gg, Gg^Efm, Gll^Efm, Gll, Gs^Fds, Gs^Fds, Gs^Fds, Gs^Fds, Gs^Fds, Gs^Fds, Gs^Fds, Re, Re, Gs^Fds, Gs^Fds, Gs^Fds, Gg, Gll^Fp, Gll^Fp, Hh, Gll^Fp
Mm, Mm, Mm, Mm, Hh, Gg, Gll^Fp, Gll^Fp, Gll^Fp, Gll^Fp, Gg^Fet, Gs^Fds, Re, Gs^Fms, Gs^Fms, Gs^Fms, Gs^Fms, Gs^Fds, Re, Gg^Fet, Ce, Gs^Fds, Gs^Fds, Gll^Fp, Gg^Fet, Gll^Fp, Gll^Fp
Mm, Mm, Mm, Mm, Mm, Hh^Fp, Gll^Fp, Gs^Vc, Gll^Fp, Gll^Fp, Gs^Fms, Gs^Vl, Gs^Fds, Gs^Fds, Gs^Fds, Gs^Fms, Gs^Fds, Gs^Fds, Gs^Vl, Ce, 2 Ke, Ce, Gs^Fds, Gs^Fds, Gll^Fp, Gll^Fp, Gg^Efm
Mm, Mm, Mm, Mm^Vhh, Mm, Hh^Fp, Gll^Fp, Gll^Fp, Gs^Fms, Gs^Fms, Gs^Fms, Gs^Fms, Gs^Fds, Gll^Fp, Gll^Fp, Gs^Fds, Gll^Fp, Gll^Fp, Gll^Fp, Gg^Efm, Gs^Fp, Ce, Gs^Fds, Gs^Fds, Gll^Fp, Gg^Efm, Gg^Efm
Mm, Mm, Mm, Mm, Mm, Hh^Fp, Mm, Gll^Fp, Gs^Fms, Gll^Fp, Gg, Gs^Fds, Gs^Fms, Gll^Fp, Gg, Gll^Fp, Gs^Fms, Gll^Fp, Gs^Fms, Gg^Efm, Gg, Gg^Efm, Gg, Gll^Fp, Gg, Gg^Efm, Gg
Mm, Mm, Mm, Mm, Mm, Mm, Mm, Mm, Gs^Fms, Gs^Fms, Gs^Fms, Gs^Fms, Gs^Fms, Gs^Vl, Gs^Fms, Gs^Fms, Gs^Fms, Gg, Gs^Fms, Gs^Fms, Gs^Fms, Gs^Fms, Gs^Fms, Gg, Gs^Fms, Gs^Fms, Gs^Fms
Gg, Mm, Mm, Mm, Mm, Mm, Mm, Mm, Gg, Gg, Gs^Fms, Gs^Fms, Gs^Fms, Gs^Fms, Gs^Fms, Gs^Fms, Gs^Fms, Gs^Fms, Gg, Gs^Fms, Gg, Gs^Fms, Gs^Fms, Gs^Fms, Gs^Fms, Gs^Fms, Gs^Fms
