Mm, Mm, Mm, Mm, Mm, Hh^Fp, Gll^Fp, Gll^Fp, Gs^Fms, Gll^Fp, Gs^Fms, Gs^Fds, Gs^Fds, Gll^Fp, Gll^Fp, Gll^Fp, Gll^Fp, Gll^Fp, Gll^Fp, Gg^Efm, Gs^Fp, Gg^Efm, Gs^Fds, Gll^Fp, Gll^Fp, Gg^Efm, Gg^Efm
Mm, Mm, Mm, Mm^Vhh, Mm, Hh^Fp, Gll^Fp, Gll^Fp, Gll^Fp, Gs^Fms, Gs^Fms, Gs^Fms, Gs^Fds, Gll^Fp, Gs^Fds, Gs^Fds, Gs^Fds, Gll^Fp, Gs^Vl, Gg^Efm, 2 Ke, Ce, Gs^Fds, Gs^Fds, Gll^Fp, Gg^Efm, Gg^Efm
Mm, Mm, Mm, Mm, Hh, Hh^Fp, Gll^Fp, Gg^Ve, Gll^Fp, Gll^Fp, Gg^Fet, Gs^Vl, Re, Gs^Fds, Gs^Fms, Gs^Fms, Gs^Fms, Gs^Fds, Re, Ce, Ce, Ce, Gs^Fds, Gs^Fds, Gg^Fet, Gll^Fp, Gll^Fp
Mm, Mm, Mm, Mm, Gg, Gg, Gg, Gll^Fp, Gll^Efm, Gll^Fp, Gs^Fds, Gs^Fds, Gs^Fds, Gs^Fms, Gs^Fds, Gs^Fms, Gs^Fds, Gs^Fds, Re, Gg^Fet, Gs^Fds, Gs^Fds, Gg, Gll^Fp, Gll^Fp, Gll^Fp, Gll^Fp
Mm, Mm, Mm, Mm^Vhh, Gg, 4 Gg, Gg, Gg^Efm, Gll^Fp, Gll, Gs^Fds, Gs^Fds, Gs^Fds, Gs^Fds, Gg, Gs^Fds, Re, Re, Re, Gs^Fds, Gs^Fds, Gs^Fds, Gll^Fp, Gll^Fp, Re, Hh, Re
Mm, Mm, Mm, Hh, Gg, Gg, Gg, Gg, Gg, Gg, Gg, Gs^Fds, Gg, Gg, Gs^Vc, Re, Gg, Gg, Re, Gs^Vc, Re, Re, 1 Re, Re, Hh, Re, Hh
Re, Mm, Hh, Hh, Gg, Gg, Gg, Gs^Vc, Gg, Gg, Gg, Gg, Gg, Gg, Gg, Gg, Re, Re, Re, Re, Gll^Fp, Gg, Hh, Hh, Hh, Hh^Vhh, Hh
Mm, Re, Re, Hh, Re, Gll^Fp, Gg, Gg, Gg, Gg, Gg, Gg, Gg^Ve, Gll^Fp, Gs^Fds, Re, Gll^Fp, Gg, Gs^Fds, Gs^Fds, Gg^Fet, Gs^Fds, Hh, Hh, Hh, Hh, Hh
Hh^Fp, Hh^Fp, Gg, Re, Gg, Re, Ch, Ch, Re, Gg^Fet, Gs^Fds, Gll^Fp, Gs^Fds, Gs^Fds, Re, Re, Gg^Fet, Gs^Fms, Gs^Fds, Gs^Fds, Gll^Fp, Gs^Fds, Hh, Hh, Hh, Hh^Vhh, Hh
Gg, Gg, Gg, Gg, Gs, Gg, Ch, 3 Kh, Gg, Re, Re, Gs^Fds, Re, Re, Re, Gs^Fds, Gs^Fds, Gs^Fms, Gll^Fp, Gs^Fds, Gs^Fds, Gs^Fds, Hh, Hh^Vhh, Hh, Hh, Hh
Wwf, Wwf, Wwf, Gs^Vh, Wwf, Gg, Wwf, Gg, Gs^Vh, Re, Gll^Efm, Re, Ce, Gg^Fet, Ke, Gg^Fet, Gll^Fp, Gs^Fds, Gs^Fds, Gs^Fds, Gg, Hh, Gg, Hh, Gg, Hh, Hh
Wwf, Wwf, Wwf, Wwf, Wwf, Wwf, Wwg, Wwf, Wwf^Bw|, Wwf, Wwf, Gs^Vh, Wwf, Ce, Wwf, Gg, Gs^Vh, Gg, Gg, Gg, Wwf^Bw|, Gs^Vh, Wwf, Gg, Gg, Gg, Wwf
Wwt, Wwf, Wwf, Ww^Ewl, Wwg, Wwg, Wwg, Wwg, Wwf^Bw|, Ww^Ewl, Wwf, Wwf, Wwf, Wwf, Wwg, Wwf, Wwf^Bw|, Wwf, Wwf, Wwf, Wwf, Wwf, Wwf, Wwf, Ww^Ewl, Wwf, Wwf
Wwt, Wwt, Wwt, Wwt, Wwt, Wwg, Wwg, Wwg, Wwg^Bw|, Wwf, Wwg, Wwg, Wwg, Wwg, Wwg, Wwg, Wwg, Wwg, Wwg, Wwf, Wwg, Wwf, Wwg, Wwf, Wwf, Wwf, Wwf
Wo, Wo, Wo, Wwt, Wo, Wwt, Wo, Wwg, Wwt, Wwg, Wwg, Wwg, Wwr, Wwg, Wwt, Wwg, Wwt, Wwg, Wwg, Wwg, Wwt, Wwg, Wwg, Wwg, Wwt, Wwt, Wwg
Wo, Wo, Wo, Wo, Wo, Wo, Wo, Wo, Wo, Wo, Wo, Wwt, Wo, Wwt, Wwt, Wwt, Wwt, Wwg, Wwt, Wwr, Wwg, Wwg, Wwt, Wwg, Wwg, Wwg, Wwt
Ww, Wo, Ww, Wo, Ww, Wo, Wo, Wo, Wo, Wo, Wo, Wo, Wo, Wo, Wo, Wwt, Wo, Wwt, Wo, Wwt, Wo, Wwt, Wo, Wwt, Wwr, Wwt, Wo
Ww, Ww, Hh, Ww, Ww, Ww, Ww, Wwr, Wo, Wo, Wo, Wo, Wo, Wo, Wo, Wo, Wo, Wo, Wo, Wo, Wo, Wo, Wo, Wo, Wo, Wo, Wo
Hh, Hh, Hh, Ds, Ds, Ds, Ww, Ww, Ww, Ww, Ww, Wo, Wo, Wo, Wo, Wo, Wo, Wo, Wo, Wo, Wo, Wo, Wo, Wo, Wo, Wo, Wo
Mm, Mm, Hh, Hh, Hh, Ds, Ds, Ds, Gll^Fp, Ds, Ww, Ww, Ww, Ww, Ww, Ww, Ww, Ww, Ww, Ww, Ww, Wo, Ww, Ww, Ww, Wo, Ww
Mm, Mm, Mm, Hh, Hh, Gg, Gll, Gll^Fp, Gg^Fet, Gll^Fp, Gll^Fp, Ww, Ds, Ww, Ww, Ww, Cv, Cv, Cv, Ww, Ww, Ww, Ww, Ww, Ds, Ww, Ww
Mm, Mm^Vhh, Mm, Mm, Hh, Gg, Gg, Gll^Fp, Gll^Fp, Gll^Fp, Gll^Fp, Gll^Fp, Gll^Fp, Ds, Ds, Cv, Cv, Cv, Cv, Cv, Gll^Fp, Gll^Fp, Gll^Fp, Ds, Gll^Fp, Ds, Ds
Mm, Mm, Mm, Mm, Mm, Hh, Hh^Fp, Gll^Fp, Gll^Fp, Gll^Fp, Gg^Fet, Gll^Fp, Gll^Fp, Gll^Fp, Gll^Fp, Cv, Gll^Fp, Kv, Gll^Fp, Cv, Gll^Fp, Gg^Ve, Gll^Fp, Gll^Fp, Gll^Fp, Gll^Fp, Gll^Fp
Mm, Mm, Mm, Mm, Mm, Mm, Hh^Fp, Gll^Fp, Gll^Fp, Gll^Fp, Gll^Fp, Gll^Fp, Gll^Fp, Gll^Fp, Gll^Fp, Gll^Fp, Gll^Fp, Gll^Fp, Gll^Fp, Gll^Fp, Gll^Fp, Gll^Fp, Gll^Fp, Gg^Fet, Gll^Fp, Gll^Fp, Gll^Fp
Mm, Mm, Mm, Mm, Mm, Mm, Mm, Gg, Gll^Fp, Gll^Ve, Gll^Fp, Gll^Fp, Gll^Fp, Gg^Fet, Gll^Fp, Gll^Fp, Gll^Fp, Gll^Ve, Gll^Fp, Gll^Fp, Gll^Fp, Gll^Fp, Gll^Fp, Gll^Fp, Gg^Fet, Gll^Fp, Gll^Fp
Mm, Mm, Mm, Mm^Vhh, Mm, Mm, Mm, Gll^Fp, Gll^Fp, Gll^Fp, Gll^Fp, Gg^Fet, Gll^Fp, Gll^Fp, Gll^Fp, Gg^Fet, Gll^Fp, Gll^Fp, Gll^Fp, Gg^Fet, Gll^Fp, Gg^Ve, Gll^Fp, Gll^Fp, Gll^Fp, Gll^Fp, Gll^Fp
Mm, Mm, Mm, Mm, Mm, Mm, Mm, Gll^Fp, Gll^Fp, Gll^Fp, Gll^Fp, Gll^Fp, Gll^Fp, Gll^Fp, Gll^Fp, Gll^Fp, Gll^Fp, Gll^Fp, Gll^Fp, Gll^Fp, Gll^Fp, Gg, Gll^Fp, Gll^Fp, Gll^Fp, Gll^Fp, Gll^Fp
