Dd^Edt, Hd, Rrd, Dd^Esd, Dd, Ds^Edt, Dd^Esd, Dd, Dd, Hd, Dd, Ds^Edt, Gd^Esd, Gs, Hhd^Esd, Hhd, Hhd^Esd, Gd, Gd, Gd, Hd, Hd, Gd, Gd, Gd, Gd, Gd, Gd, Gd^Dr, Gd, Gd^Esd, Gd, Gd^Esd, Gd^Esd, Gd, Gll^Fdw, Gll^Fdw, Gd, Ce, Gd, Gd, Dd, Gd, Re, Re, Dd^Esd, Gd, Dd, Re, Ds^Edt
Mdd, Mdd, Hd, Rrd, Rd, Dd, Dd^Vda, Dd, Ds^Esd, Ds^Esd, Dd^Esd, Dd^Vdt, Gd, Hhd^Esd, Gd^Efm, Hhd^Esd, Hhd, Dd^Esd, Dd, Hd, Dd^Esd, Hd^Esd, Gd, Ds, Hd, Ds, Gd^Esd, Gs^Es, Gd^Es, Gs^Es, Gs^Dr, Gs, Gs^Es, Gd^Esd, Gd, Gll^Fdw, Gd, Gd, Ce, Ce, Re^Vct, Rb, Rb^Ecf, Re^Vct, Re, Gd, Ce, Ce, Gd, Rb
Mdd, Mdd, Hd, Ds, Re^Vct, Ds, Dd, Gd, Ds^Esd, Ds^Esd, Hd, Dd, Gd, Gd^Efm, Gd^Efm, Gd^Efm, Gd^Efm, Gd^Efm, Gd^Efm, Dd, Gd, Gd, Gd^Efm, Gd, Gd, Hd^Esd, Ds^Esd, Gd, Gd^Esd, Gd^Dr, Gd^Esd, Gs, Gd, Gd, Gd, Gd, Gs, Gd, Re^Vct, Gd, Re, Rb, Re, Re^Vct, Re, Ce, Re^Vct, 7 Ke, Ce, Gd
Hd, Hd, Ds^Esd, Ds, Ds, Rd, Ce, Dd, Dd^Vdt, Ds, Hd, Gd, Gd, Gd, Gd, Dd, Gd, Gs^Efm, Gs, Gd^Vo, Dd, Gd, Hhd, Gd, Gd, Ds, Gll^Fdw, Gd^Esd, Gd, Gd^Esd, Gd, Gll^Fdw, Gll^Fdw, Gll^Fdw, Gll^Fdw, Dd, Dd, Gd, Gd, Re, Gd, Re^Vct, Re, Rb, Gd, Gd, Gd, Ce, Ce, Dd
Ds, Ds, Dd, Dd^Vda, Ds^Esd, Ce, 2 Ke, Ce, Dd, Gd, Hd, Gd, Gd, Dd, Dd, Gd, Gd^Esd, Dd^Esd, Gd, Gd, Hhd^Esd, Hhd^Esd, Hhd, Gd, Gd, Gll^Fdw, Gll^Fdw, Gd, Gs, Dd, Gd, Gs, Gll^Fdw, Gll^Fdw, Gll^Fdw, Gll^Fdw, Gd, Ce, Dd, Rb, Rb^Esd, Ce, 3 Ke, Ce, Gd, Ce, Ds, Gd, Ds, Dd
Ds, Dd, Hd, Dd, Ds^Edt, Ce, Ce, Ce, Hd, Ds, Mdd, Hd, Ds, Gd, Dd, Dd, Rd, Dd, Dd^Esd, Ds^Esd, Ds, Hhd, Ds, Hd, Ds, Gd, Gd, Gs, Gd, Gd, Gd, Gll^Fdw, Gd, Gll^Fdw, Gs, Gd, Gd, Gd^Efm, Gd^Efm, Re^Vct, Re, Re^Vct, Ce, Ce, Gd, Dd^Vdt, Ds, Gd, Ce, Ce
Dd, Dd^Vdt, Dd, Hd, Hd, Hd, Ds, Re^Vct, Hd, Hd^Esd, Ds, Hd, Gd, Ds, Ds^Esd, Dd^Esd, Ds, Rd, Dd^Do, Dd, Dd^Ftd, Ds, Hd^Em, Hd^Dr, Ds, Gd, Gd^Vo, Dd, Gd, Gll^Fdw, Gd, Gd^Esd, Dd, Gd, Gd, Gd^Efm, Gd^Efm, Gd^Efm, Rb, Ce, Gs^Efm, Gd^Efm, Gs, Re^Vct, Gd, Ds^Esd, Ds, Dd^Vdt, Dd, Ce
Dd, Dd^Vdt, Dd, Hd, Dd, Ds, Ce, Ce, Rrd, Dd, Ds^Dr, Dd, Dd, Dd, Dd^Do, Ds^Esd, Ds, Dd, Hd, Dd, Wwg, Dd^Vda, Dd, Hd, Gd, Gd, Gd^Esd, Gs^Esd, Gd, Gd, Gs, Dd^Esd, Dd^Esd, Gd^Esd, Dd, Dd, Dd, Gd, Rb, Rb, Gd^Efm, Ce, Gd, Gd, Gd, Ds, Ds, Ce, Dd, Dd
Dd, Dd, Dd, Dd, Hd, Hd, Hd, Ds, Ds, Rrd, Ds, Ds, Dd, Dd, Dd, Ds^Edt, Dd, Dd, Dd, Hd, Wwg, Wwg, Dd^Ftd, Dd, Gd^Esd, Gd, Gd, Gs, Dd, Gll^Fdw, Gs, Gd, Gd, Gd, Gll^Fdw, Gd, Gd, Gs, Gs, Gd^Efm, Gd^Efm, Gd, Gd^Esd, Ce, Ds, Ds^Vdr, Dd, Dd, Dd, Dd
Dd, Hd, Hd, Dd, Dd, Hd, Dd, Dd, Ds^Vdr, Ds, Ds, Rd, Rd, Rd, Dd, Dd, Dd^Esd, Dd, Dd^Esd, Hd^Ftd, Dd^Ftd, Gd, Dd, Ds^Esd, Dd, Dd, Dd, Gd, Dd, Gd, Gd, Dd, Gd, Gd, Gd, Gll^Fdw, Rb, Rb, Gs, Gd, Gd, Gd, Gd, Ds^Esd, Gd, Gd^Esd, Gd^Esd, Dd, Dd, Dd
Dd^Esd, Dd, Dd, Dd, Dd, Dd, Dd, Dd^Esd, Hd^Esd, Ds, Ds^Esd, Ds^Esd, Hd, Rd, Dd, Dd, Dd, Dd, Dd, Dd, Dd^Do, Dd, Dd, Ds^Fdw, Dd, Dd, Dd^Dr, Dd^Es, Dd^Fdw, Ds, Hd, Gd, Gll^Fdw, Gd, Dd, Gs, Rb, Gs, Gd, Gs^Esd, Gs^Dr, Gd^Dr, Gd, Gd, Gs, Gd, Gd, Dd^Esd, Gll^Fdw, Gd
Dd, Dd, Ds, Dd, Ds^Edt, Dd, Dd, Dd, Hd, Ds, Ds^Edt, Hd^Edt, Hd, Hd, Ds, Dd, Dd, Hd, Hd, Dd, Ds, Ds, Co, Dd, Dd^Edt, Dd, Dd, Dd, Dd, Hd, Ds, Gd, Gd, Gd, Re^Edt, Rb, Gd, Gd, Gd, Gd, Gd, Gs^Es, Gd^Es, Gd, Gs^Efm, Gd, Gd^Efm, Gd, Gs, Gd^Esd
Hd, Dd, Dd, Ds^Esd, Ds, Dd^Edt, Dd, Dd, Dd, Hd, Co, Co, Co, Hd, Ds^Vdr, Ds^Edt, Dd, Ds^Vdr, Dd, Dd^Esd, Dd, Ds, Co, Co, Dd^Edt, Dd, Hd, Dd, Gd^Edt, Gd, Co, Co, Co^Edt, Gd, Re, Re^Edt, Gd, Co, Co^Edt, Gd^Edt, Gs, Gs, Gd^Efm, Gd^Efm, Gs^Efm, Gd^Efm, Gd^Efm, Gd, Gs, Gs
Dd, Hd, Dd^Esd, Ds, Ds, Dd, Dd, Hd, Hd, Dd^Edt, Co, Ko, Gd, Co^Edt, Gd, Rrd, Rrd, Dd, Dd, Dd^Esd, Dd, Co, Ds, Urb^Qhu, Urb^Qhu, Co^Edt, Co^Dr, Co, Co^Edt, Gd, Urb^Qhu, Ko, Co, Gd, Urb^Qhu, Re, Urb^Qhu, Gd^Vo, Co^Edt, Gd^Dr, Gd, Gd^Efm, Gd, Gd^Efm, Gd, Gd, Gd, Dd, Dd, Gd
Dd, Dd, Dd^Esd, Dd, Dd, Ds, Dd, Dd, Gd, Urb^Qhu, Urb^Qhu, Urb^Qhu, Rb, Re, Re, Gd^Vo, Ds, Rd, Ds^Edt, Ds, Dd, Dd^Edt, Co, Co, Urb^Qhu, Co, Urb^Qhu, Gd^Vo, Re^Vo, Urb^Qhu, Urb^Qhu, Co, Gd, Co, Urb^Qhu, Urb^Qhu, Rb^Edt, Rb, Urb^Qhu, Urb^Qhu, Gd, Gs, Gd, Gd^Esd, Dd, Gd^Esd, Gd^Esd, Gd, Gs, Gd
Rd, Dd, Dd^Vda, Dd, Ds^Esd, Ds^Esd, Dd^Esd, Ds, Gd^Edt, Rb^Vo, Rb, Urb^Qhu, Gd, Re, Re^Edt, Re, Gd, Rd, Rb, Ds, Co, Co^Edt, Co, Gd^Vo, Gd, Urb^Qhu, Urb^Qhu, Re, Rb^Edt, Urb^Qhu, Rb^Vo, Ur^Edt, Ur, Urb^Qhu, Urb^Qhu, Re^Ecf, Re, Urb^Qhu, Urb^Qhu, Co^Edt, Co^Edt, Gd, Gd, Dd^Esd, Gd, Gd, Dd, Gs, Gd, Gd
Dd, Ds, Ds, Ds, Dd^Esd, Ds^Esd, Co, Dd^Ftd, Dd^Ftd, Dd, Dd, Hd, Hd^Edt, Gd, Re, Rb^Edt, Rb, Rb^Ecf, Rb, Rb, Gd, Gd, Urb^Qhu, Co, 4 Ko, Co, Rb, Rb, Urb^Qhu, Ur^Dr, Ur^Dr, Ur, Ur, Co, Co, Ur, Ur, Ur, Co, Ko, Gd^Vhr, Gd, Gd, Gd, Gs, Gd, Gd, Gd, Gd^Esd, Gd
Dd, Dd, Dd, Dd^Esd, Dd^Esd, Dd^Esd, Co, Hd^Em, Wwg, Wwg, Wwg, Dd^Em, Dd^Ftd, Ds, Co^Edt, Co, Gd^Vo, Rb, Gd, Urb^Qhu, Urb^Qhu, Urb^Qhu, Urb^Qhu, Co, Co, Gd, Urb^Qhu, Urb^Qhu, Urb^Qhu, Ur^Dr, Qxu, Qxu^Qhh, Qxu, Ur, Co, Co^Dr, Ur, Gd, Gd, Co, Co, Gd, Gs, Gd, Gs, Gd, Gd^Es, Gd, Gd^Esd, Gd^Esd
Rd, Dd, Dd, Dd, Dd, Co^Edt, Co^Edt, Wwg, Wog, Wog, Wwg, Dd^Ftd, Dd^Ftd, Co^Dr, Ko, Ko, Co^Edt, Urb^Qhu, Re, Gd, Gd^Edt, Ur^Qhh, Urb^Qhu, Urb^Qhu, Gd, Gd, Gd^Vo, Urb^Qhu, Ur, Ur, Qxu, Qxua^Qhux, Qxu, Ur^Edt, Ur^Edt, Gd^Vo, Ds^Edt, Co, Co, Gd, Ds^Esd, Gd^Esd, Dd^Esd, Gd, Gs^Esd, Gd, Gs^Dr, Gs, Gd^Dr, Gd^Dr
Ds, Dd, Ds, Dd, Dd, Hd, Hd^Ftd, Dd^Ftd, Wwg, Wog, Wog, Wwg, Dd, Co, Dd, Ko, Co^Edt, Co^Edt, Rb, Rb^Vo, Re^Edt, Re, Rb, Rb, Re^Ecf, Rb^Edt, Co^Edt, Co, Urb^Qhu, Ur, Ur, Qxu^Qhh, Ur^Es, Ur, Urb^Qhu, Ds^Edt, Dd, Co, Gd, Gd, Dd, Dd, Gd^Esd, Gd, Gd^Esd, Gs^Es, Gs^Es, Gd, Gd, Gd^Dr
Dd^Esd, Dd, Ds, Ds, Dd, Dd, Dd, Dd^Ftd, Dd^Em, Wwg, Wwg, Wwg, Dd^Edt, Hd, Hd^Edt, Hd, Hd, Dd, Gd^Vo, Rb^Edt, Gd, Urb^Qhu, Urb^Qhu, Re, Re, Re^Edt, Urb^Qhu, Co, Urb^Qhu, Urb^Qhu, Gd, Ur, Ur, Urb^Qhu, Urb^Qhu, Gd, Dd, Dd^Edt, Dd^Edt, Dd, Dd, Gd, Gs, Gd^Esd, Gs, Gd, Gd, Gd^Dr, Gd, Gd
Dd^Edt, Dd^Edt, Dd, Ds, Ds, Dd, Dd^Edt, Co^Edt, Co^Dr, Dd^Ftd, Hd^Ftd, Ds, Ds^Edt, Hd, Hd, Dd, Co^Dr, Co^Edt, Rd, Gd^Vo, Co, Urb^Qhu, Gd, Co, Gd, Urb^Qhu, Urb^Qhu, Urb^Qhu, Rrd, Urb^Qhu, Co, Ur^Vo, Rb^Vo, Co, Co^Dr, Gd, Gd, Dd^Edt, Dd^Edt, Gd, Gd^Efm, Gd, Gd, Gd, Ce, Gll^Fdw, Ds, Gs, Gd, Gd
Dd, Dd, Ds, Ds, Ds, Ds, Ds^Edt, Ds^Edt, Dd, Dd^Ftd, Hd^Em, Ds^Vdr, Dd, Hd, Hd^Vdr, Dd, Dd, Co^Edt, Ds, Dd^Edt, Dd, Co, Ko, Gd^Vo, Co^Edt, Co^Edt, Ds, Rrd^Edt, Dd^Esd, Rrd, Ds^Esd, Co, Co, Co^Edt, Dd^Edt, Gd, Dd, Gd, Gs, Gd, Gs, Gs, Ce, Ce, Gd, Gd, Dd^Esd, Ds^Esd, Ds, Ds
Ds, Dd, Ds^Esd, Ds, Ds, Ds, Ds, Dd, Dd, Dd, Ds, Dd, Dd, Dd, Dd, Hd, Dd^Esd, Rrd, Ds^Edt, Dd^Edt, Gd, Co^Edt, Co, Dd, Co, Dd, Rd, Dd, Dd^Esd, Dd^Esd, Dd^Vdr, Dd^Dr, Dd, Dd, Dd^Vdr, Dd, Gd, Gs, Gs, Gs, Ce, Ce, Gs^Efm, Gd, Gs, Dd, Dd^Vdt, Dd^Esd, Ds, Ds
Ds^Dr, Ds, Ds^Esd, Ds^Esd, Ds, Ds, Dd, Ds, Ds, Hd, Hd^Esd, Ds, Dd^Do, Dd, Rd, Rd, Rd, Dd^Edt, Dd, Ds, Gd, Ds^Dr, Ds, Ds, Ds, Rd, Ds, Dd, Dd, Dd^Esd, Dd, Dd, Ds, Ds^Edt, Ds, Gd, Dd^Edt, Gd, Dd^Edt, Ce, Gd, Gd^Es, 1 Ce, Ce, Ce, Re^Vct, Gd, Gd^Esd, Ds^Esd, Ds
Hd^Dr, Ds^Dr, Ds^Es, Ds^Es, Ds^Dr, Ds^Esd, Ce, Dd, Dd, Dd, Ds, Ds, Dd, Dd, Dd, Dd, Gd, Gd, Gs, Ds^Esd, Dd^Esd, Ds^Vdr, Dd^Edt, Ds^Edt, Ds, Rd, Dd^Vda, Ds, Dd, Dd, Hd, Gd, Dd, Gd, Ds, Gd, Dd, Dd^Edt, Dd, Gd, Gd, Ce, Ke, Ce, Ce, Gd^Esd, Re^Vct, Gd, Ds^Esd, Gd
Hd, Dd, Dd, Ds^Es, Dd^Vda, 5 Ce, Ke, Ce, Dd, Dd, Dd^Esd, Dd^Esd, Dd, Rrd, Dd, Ds, Ds, Gs, Gs, Ds^Esd, Ds, Dd, Dd, Dd, Ds, Ds, Dd, Ds, Ds, Dd, Dd, Hd, Dd^Esd, Ds, Ds, Dd^Vdr, Dd^Edt, Dd, Gd, Re^Vct, Gd, Ce, Ce, Ce, Gd^Efm, Gd, Ds, Ds, Gs, Gd
Dd, Hd, Hd, Dd, Dd^Vdt, Ce, Ce, 6 Ce, Ds, Dd, Dd, Ds^Vdr, Dd^Es, Rrd, Dd, Ds, Ds, Ds, Hd, Ds, Gd, Dd, Gd, Dd, Ds^Fdw, Dd^Esd, Dd^Edt, Ds, Rrd, Gd, Gd, Dd, Dd^Esd, Gd, Dd, Ds, Dd^Edt, Dd^Edt, Gd, Dd, Dd, Dd, Gd, Gd, Gd, Gd^Vhr, Gs, Gd, Gd, Gs
Dd, Dd, Hd, Hd, Hd, Dd^Vda, Ds, Dd^Vda, Rrd, Ds, Ce, Ds, Rd, Dd, Dd, Dd^Dr, Dd, Ds, Gd, Hd^Esd, Gd, Gd, Gd^Esd, Gll^Fdw, Gd, Dd^Edt, Dd, Dd, Ds, Rrd, Rd, Dd, Gd, Gd^Esd, Gd, Gd, Gd, Gs, Ds, Dd^Vdt, Dd, Gd, Gs, Re^Vct, Gd, Re^Vct, Gd, Gs^Dr, Dd, Gs
Dd, Dd^Vda, Dd, Dd, Dd, Dd, Rd, Rd, Dd^Vdt, Rrd, Rrd, Rd, Ds, Dd, Dd, Ds^Esd, Ds, Gd, Gd^Vo, Dd, Gs, Gs, Gs, Gd^Esd, Gll^Fdw, Gd, Dd, Gd^Vo, Gll^Fdw, Gd, Dd, Gd, Gs^Esd, Ds, Gd^Esd, Gs^Esd, Ds, Dd, Gd, Gd, Dd^Vdt, Gd, Gs^Esd, Gd^Esd, Dd, Dd, Dd, Dd, Gs, Rd
Hd, Dd, Dd, Dd^Vdt, Dd, Dd, Rd, Dd, Dd^Esd, Ds, Ds, Ce, Gs^Dr, Gs, Gd^Esd, Gd, Gd^Esd, Gs^Esd, Gll^Fdw, Gll^Fdw, Gll^Fdw, Gs, Dd, Gd, Gll^Fdw, Gll^Fdw, Gs^Efm, Gs, Gs^Efm, Gs^Es, Gd, Gd^Dr, Gs^Efm, Gd, Gs, Gs, Dd, Dd, Gs, Gs, Dd, Dd^Esd, Dd^Esd, Gs^Esd, Gd, Dd, Ds, Dd, Gs, Ds
Dd, Hd, Ds, Dd, Dd, Rd, Dd, Dd, Dd, Hd^Esd, Ds, Ds^Esd, Gd, Gs^Dr, Gd, Gs, Gs, Gd, Gd, Gll^Fdw, Gd, Gd, Gd, Dd, Gd, Gll^Fdw, Gs^Efm, Gd^Efm, Gd^Efm, Gs^Efm, Gd^Dr, Gd^Es, Gd, Gs^Efm, Gd, Gs, Gd, Dd, Gd, Gd, Rd, Dd, Dd, Dd, Ds, Dd, Dd, Ds, Ds, Ds
