Hh, Hh, Hh, Hh, Mm, Hh, Mm, Hh, Mm, Mm, Mm, Hh, Hh, Hh, Hh, Hh, Gll^Fp, Gll^Fp, Gll^Fp, Gll^Fp, Hh, Hh, Mm, Mm, Mm, Mm, Mm, Mm, Mm, Mm, Mm, Mm, Mm, Mm, Mm, Mm, Mm, Hh, Hh, Hh, Hh, Ds, Ds, Ww, Ww, Ww, Wo, Wo, Wo, Wo, Wo, Wo, Wo, Wo, Wo, Wo, Wo, Wo, Wo, Wo, Wo, Wo
Hh, Hh, Hh, Hh, Mm, Hh, Mm, Hh, Mm, Mm, Mm, Hh, Hh, Hh, Hh, Hh, Gll^Fp, Gll^Fp, Gll^Fp, Gll^Fp, Hh, Hh, Mm, Mm, Mm, Mm, Mm, Mm, Mm, Mm, Mm, Mm, Mm, Mm, Mm, Mm, Mm, Hh, Hh, Hh, Hh, Ds, Ds, Ww, Ww, Ww, Wo, Wo, Wo, Wo, Wo, Wo, Ww^Vm, Wo, Wo, Wo, Wo, Wo, Wo, Wo, Wo, Wo
Mm, Mm, Mm, Mm, Mm, Mm, Mm, Mm, Mm, Mm, Mm, Mm, Hh, Hh, Gs^Vl, Gll^Fp, Gll^Fp, Gll^Fp, Gll^Fp, Hh, Hh, Hh, Mm, Mm, Mm, Mm, Mm, Mm, Mm, Mm, Mm, Mm, Mm, Mm, Mm, Mm, Mm, Mm, Mm, Hh, Hh, Ds, Ds, Ww, Wo, Wo, Wo, Wo, Kme, Kme, Wo, Wo, Wo, Wo, Dd, Dd, Ww, Wo, Ww, Wo, Wo, Wo
Mm, Mm, Mm, Mm, Mm, Mm, Mm, Mm, Mm, Mm, Mm, Mm, Gll^Fp, Gll^Fp, Gll^Fp, Gll^Fp, Gll^Fp, Hh, Hh, Gll^Fp, Gll^Fp, Hh, Hh, Mm, Mm, Mm, Mm, Mm, Mm, Mm, Mm, Mm, Mm, Mm, Mm, Mm, Mm, Mm, Mm, Hh, Hh, Ds, Ww, Ww, Wo, Ww^Vm, Wo, Wo, Kme, 9 Cme, Wo, Wo, Wo, Wo, Ww, Ww, Ds, Wo, Ww, Ww, Wo, Wo
Mm, Mm, Mm, Mm, Mm, Mm, Mm, Mm, Mm, Mm, Hh, Hh, Gll^Fp, Gll^Fp, Gll^Fp, Gll^Fp, Hh, Hh, Gll^Fp, Gll^Fp, Mm, Gll^Fp, Hh, Hh, Hh, Mm, Hh, Mm, Mm, Mm, Mm, Mm, Mm, Mm, Mm, Mm, Mm, Mm, Mm, Hh, Hh, Ds, Ww, Wo, Ww, Wo, Wo, Wo, Wo, Kme, Ww, Wo, Ww, Ww, Ds, Ds, Gg, Ds, Ds, Ww, Wo, Wo
Mm, Mm, Mm, Mm, Mm, Mm, Mm, Mm, Mm, Hh, Hh, Hh, Gll, Gll^Fp, Hh, Hh, Mm, Mm, Mm, Mm, Mm, Gll^Fp, Mm, Mm, Mm, Hh, Hh, Hh, Hh, Hh, Hh, Mm, Mm, Mm, Hh, Mm, Mm, Mm, Hh, Hh, Hh, Ds, Ds, Ww, Ww, Ww, Ww, Wo, Ww, Ww, Ds, Ww, Ww, Ww, Ds, Gs^Vh, Ds, Ds, Ds, Ww, Wo, Wo
Mm, Mm, Mm, Mm, Mm, Mm, Mm, Mm, Hh, Hh, Gll^Fp, Gll, Gg, Hh, Hh, Mm, Mm, Mm, Mm, Mm, Mm, Mm, Mm, Mm, Mm, Hh, Hh^Vhh, Hh, Hh, Hh^Vhh, Hh, Hh, Hh, Hh, Hh, Hh, Hh, Hh, Hh, Hh, Gs^Fp, Ds, Gs^Fp, Ds, Ds, Ww, Wo, Wo, Ww, Ds, Ds^Ewsh, Ds, Ds, Ds, Gg, Gg, Ds, Ww, Ww, Ww, Wo, Wo
Mm, Mm, Mm, Mm, Mm, Mm, Mm, Hh, Hh, Gll^Fp, Gll^Fp, Gg, Gg, Gg, Hh, Mm, Mm, Mm, Mm, Mm, Mm, Mm, Mm, Mm, Mm, Mm, Mm, Hh, Hh^Vhh, Gs^Fp, Gg, Gg^Vh, Gg, Hh, Gg, Hh, Gg, Hh, Gs^Fp, Gs^Fp, Gs^Fp, Gs^Fp, Gg, Gg, Ds, Ww, Wo, Wo, Wwg, Wwg, Ds, Gs^Vh, Gg^Efm, Gg, Gg, Gg, Ds, Ds, Ww, Wo, Wo, Wo
Mm, Mm, Mm, Mm, Mm, Mm, Hh, Hh, Gll^Fp, Gll^Fp, Gll, Gg, Gg^Efm, Gg^Efm, Hh, Hh, Hh, Mm, Mm, Mm, Mm, Mm, Mm, Mm, Mm, Mm, Mm, Hh, Gll^Fp, Gs^Fp, Gg, Gg^Vh, Gg, Gg^Vh, Gg, Ce, Gg, Gg, Re, Gg, Gg, Gg, Gg, Gg, Ds, Ww, Wo, Wo, Wwg, Ds, Ds, Gg, Gg^Efm, Gg^Efm, Ds, Ds, Ww, Ww, Wwf, Ww, Ww, Ww
Mm, Mm, Mm, Mm, Hh, Hh, Hh, Hh, Gll^Fp, Gll^Fp, Gll, Gg, Gg^Efm, Gll^Fp, Gll^Fp, Hh, Hh, Mm, Mm, Mm, Mm, Mm, Mm, Mm, Mm, Mm, Mm, Gll^Fp, Gll, Gg^Vh, Gg, Gg, Gg, Gg^Vh, Gg^Vh, Ce, Gg, Re^Gvs, Re^Gvs, Re^Gvs, Re, Re, Gg, Gg, Ds, Ww, Ww, Wo, Wo, Ww, Ds, Gg, Ds, Ds, Ww, Ww, Ds, Wwf, Wwf, Wwf, Ds, Ds
Hh, Hh, Hh, Hh, Hh, Hh, Hh, Gll^Fp, Gll^Fp, Gll, Gg, Gg^Efm, Gll^Fp, Gll^Fp, Gll^Fp, Gll^Fp, Hh, Gd^Vo, Mm, Mm, Mm, Mm, Mm, Mm, Mm, Mm, Gg, Gg^Vh, Ce, Gg^Vh, Ce, Gg^Vh, Ce, Gs, Gs, Ce, Gg, Re^Gvs, Re^Gvs, Re^Gvs, Re^Gvs, Re, Re^Gvs, Gg, Gg, Ds, Ds, Ww, Ww, Ww, Ds, Gs^Vh, Ds, Ww, Ds, Ds, Wwf, Wwf, Gg, Gg, Gg, Gg
Hh, Hh, Hh, Hh, Hh, Hh, Hh, Hh, Gg, Gg, Gg, Gg^Efm, Gg, Gll^Fp, Hh, Gll^Fp, Hh, Hh, Hh, Mm, Mm, Mm, Mm, Mm, Ce, Gg^Vh, Gg, Gg^Vh, Ce, 8 Ke, Ce, 3 Ke, Ce, Gs, Gg^Vh, Ce, Gg, Re, Re^Gvs, Re^Gvs, Re^Gvs, Re^Gvs, Re^Gvs, Gg, Re^Gvs, Gg, Gg, Ds, Ds, Ds^Ewsh, Ww, Ds, Ww, Ww, Wwf, Wwf, Re^Gvs, Gg, Re, Gg, Gg, Gg
Hh, Hh, Hh, Hh, Hh, Gd^Vo, Hh, Hh, Hh, Gg, Gg, Gg^Efm, Gg^Efm, Gll^Fp, Hh, Hh, Hh, Hh, Hh, Hh, Hh, Hh, Hh, Hh, Ce, Gg, Gg^Vh, Gg, Ce, Ce, Ce, Ce, Ce, Gg, Gg, Ce, Gg, Re, Re, Re^Gvs, Re^Gvs, Gd^Vo, Rd, Re^Gvs, Re^Gvs, Gg, Rd, Gg, Gg, Ww, Wwg, Ww, Wwf, Wwf, Re^Gvs, Re^Gvs, Re^Gvs, Gg, Re, Gg, Gg, Gg
Hh, Hh, Mm, Mm, Mm, Hh, Hh, Hh, Hh, Gg, Gg, Gg, Gg, Gg, Gg, Hh, Hh, Hh, Hh, Hh, Hh, Hh, Hh, Gs, Ce, Gg, Gg^Vh, Gs^Fp, Gg, Gg^Vh, Gg, Gg^Vh, Gg, Gg^Vh, Gg, Ce, Gg, Gg, Re^Gvs, Re^Gvs, Re^Gvs, Rd, Re^Gvs, Rd, Rd, Rd, Gg, Rd, Rd, Wwg, Wo, Ww, Wwf, Wwf, Re^Gvs, Re^Gvs, Re, Re, Re, Gg, Gg, Gg
Hh, Hh, Mm, Mm, Mm, Mm, Mm, Mm, Mm, Hh, Hh, Gg^Efm, Gg, Gs^Fp, Gg, Re^Gvs, Re^Gvs, Re^Gvs, Re, Re, Re^Gvs, Hh, Gs, Gs, Gs, Ce, Ce, Ce, Ce, Gg, Gs, Gg, Ce, Ce, Ce, Ce, Gg, Re^Gvs, Re, Re^Gvs, Rd, Rd, Gll^Fp, Gll^Fp, Wwg, Wwg, Wwg, Wwg, Wo, Wo^Bw\, Rd, Rd, Rd, Re, Re, Re, Re^Gvs, Re, Re^Gvs, Gg, Gg, Gg
Mm, Mm, Mm, Mm, Mm, Mm, Mm, Mm, Mm, Mm, Hh, Gg, Gg, Gg, Re^Gvs, Re^Gvs, Re^Gvs, Re^Gvs, Re^Gvs, Gg, Re, Re^Gvs, Gs, Gs, Gs, Gs, Gs, Gs, Gs, Gs, Hh^Fp, Gs, Gs, Gs, Gs, Gg, Hh, Gg, Re, Re^Gvs, Rd, Gg^Efm, Wwg, Wwg, Ww, Ww, Gg, Ww, Re^Gvs, Rd, Re^Gvs, Re^Gvs, Re^Gvs, Re^Gvs, Re^Gvs, Re^Gvs, Re^Gvs, Re^Gvs, Gg, Gg^Efm, Gg, Gg
Mm^Xm, Mm^Xm, Mm^Xm, Mm^Xm, Mm^Xm, Mm, Mm, Mm, Mm, Mm, Hh, Hh, Re^Gvs, Gd^Vo, Gg, Re^Gvs, Gs^Fp, Re^Gvs, Re^Gvs, Gg, Rd, Re^Gvs, Gg, Gs, Gs, Gs, Gs, Gll^Fp, Gll^Fp, Gll^Fp, Re, Gs, Gs, Gs, Hh, Hh, Hh, Hh, Gg, Rd, Gg, Wwg, Wwg, Ww, Gs^Fp, Gs^Fp, Re^Gvs, Re^Gvs, Re^Gvs, Rd, Re^Gvs, Re^Gvs, Gd^Vo, Re^Gvs, Re^Gvs, Re^Gvs, Re^Gvs, Re, Re^Gvs, Gg, Gg, Gg
Mm^Xm, Mm^Xm, Mm^Xm, Mm^Xm, Mm, Mm, Mm, Mm, Mm, Mm, Hh, Gg, Gg, Re^Gvs, Re^Gvs, Gg, Re^Gvs, Re^Gvs, Rd, Rd, Hh, Rd, Rd, Rd, Rd, Gs, Rd, Gll^Fp, Rd, Re^Gvs, Re, Hh, Hh, Hh, Hh, Hh, Hh, Hh, Gs^Fp, Rd, Gg, Wwg, Ww, Ww, Gs^Fp, Gg, Re^Gvs, Re^Gvs, Re^Gvs, Rd, Re^Gvs, Re^Gvs, Re^Gvs, Re^Gvs, Re^Gvs, Re^Gvs, Re^Gvs, Re^Gvs, Re^Gvs, Gg, Gg, Gg
Mm^Xm, Mm^Xm, Mm, Mm, Mm, Mm, Mm, Mm, Mm, Hh, Hh, Gg, Gg^Efm, Re, Re, Re^Gvs, Re, Re^Gvs, Rd, Gg^Efm, Gs^Fp, Hh, Rd, Re^Gvs, Re^Gvs, Rd, Re^Gvs, Rd, Re^Gvs, Rd, Rd, Re, Rd, Gs^Fp, Gs^Fp, Hh, Hh, Hh, Rd, Rd, Wwg^Bw\, Wwg, Ww, Gs^Fp, Gg^Efm, Gg^Efm, Re^Gvs, Re^Gvs, Re^Gvs, Rd, Re, Re^Gvs, Re^Gvs, Re^Gvs, Re^Gvs, Re^Gvs, Re^Gvs, Re^Gvs, Re^Gvs, Gg, Gg, Gg
Mm^Xm, Mm^Xm, Mm, Mm, Mm, Mm, Mm, Mm, Mm, Hh, Gll^Fp, Gll^Fp, Gg^Efm, Re^Gvs, Gg, Re, Re^Gvs, Rd, Gg^Efm, Gg^Efm, Gs^Fp, Gg, Rd, Re^Gvs, Re^Gvs, Re^Gvs, Re, Rb, Re^Gvs, Re^Gvs, Rd, Rd, Re^Gvs, Rd, Rd, Rd, Wwf, Wwf, Wwf, Wwf, Wwg, Gg^Efm, Ww^Bw\, Ww, Re^Gvs, Re^Gvs, Re, Gg, Gg, Rd, Re^Gvs, Re^Gvs, Re^Gvs, Re^Gvs, Re^Gvs, Re^Gvs, Re^Gvs, Re, Gg, Gg, Gg, Gg
Mm, Mm, Mm, Mm, Mm, Mm, Mm, Gd^Vo, Hh, Hh, Gg^Efm, Gg^Efm, Re^Gvs, Re^Gvs, Re^Gvs, Re^Gvs, Rd, Rd, Hh, Hh, Hh, Rd, Re, Re^Gvs, Re^Gvs, Re^Gvs, Re, Re^Gvs, Re^Gvs, Re^Gvs, Rd, Re^Gvs, Re^Gvs, Re^Gvs, Wwf, Wwf, Wwf, Wwf, Wo, Wo, Ww, Ww, Re^Gvs, Re^Gvs, Re^Gvs, Re^Gvs, Re, Re^Gvs, Re^Gvs, Rd, Gg, Re, Gg, Gg^Efm, Re, Re, Gg, Gg, Hh, Gg, Gg, Gg
Mm, Mm, Mm, Mm, Mm, Mm, Mm, Hh, Gg, Gg, Gg, Re^Gvs, Re^Gvs, Re^Gvs, Re^Gvs, Re^Gvs, Gd^Vo, Re^Gvs, Rd, Gs^Fp, Hh, Rd, Gg, Re^Gvs, Gg^Efm, Re, Ww, Re^Gvs, Ww, Re^Gvs, Rd, Wwf, Wwg, Wwf, Ww, Wwf, Ww, Wo, Ww, Wwg, Re, Re^Gvs, Re^Gvs, Gg^Efm, Re^Gvs, Re, Re^Gvs, Re^Gvs, Re^Gvs, Rd, Gg, Gg^Efm, Hh, Gg, Hh, Hh, Hh, Hh, Gg, Gg, Gg, Gg
Mm, Mm, Mm, Mm, Mm, Mm, Mm, Hh, Hh, Gg, Gg, Re^Gvs, Gg, Re^Gvs, Re^Gvs, Re^Gvs, Rd, Rd, Re^Gvs, Rd, Rd, Rd, Gg^Efm, Gg, Ww, Ww, Co, Ww, Co, Ww, Ww^Bw|, Ww, Co, Ww, Co, Ww, Ww, Ww, Ww, Gg^Efm, Re, Re^Gvs, Re, Re^Gvs, Re^Gvs, Re^Gvs, Re^Gvs, Re^Gvs, Re^Gvs, Rd, Re, Hh, Hh, Hh, Hh, Hh, Mm, Mm, Gg, Gg, Gg^Efm, Gg^Efm
Mm, Mm, Mm, Mm, Mm, Mm, Mm, Mm, Hh, Gg, Gg, Gg, Gg, Re^Gvs, Rd, Rd, Gg, Re^Gvs, Re^Gvs, Re^Gvs, Re^Gvs, Gg^Efm, Ww, Ww, Co, Co, Mm, Co, Mm, Co, Rd, Co, Mm, Co, Mm, Co, Co, Ww, Ww, Wwg, Wwg, Re, Re^Gvs, Re, Re^Gvs, Gd^Vo, Re^Gvs, Re^Gvs, Re^Gvs, Rd, Re, Gg^Efm, Gg^Efm, Hh, Mm, Mm, Mm, Mm, Gg, Gg, Gg^Efm, Gg^Efm
Mm^Xm, Mm^Xm, Mm^Xm, Mm, Mm, Mm, Mm, Mm, Mm, Hh, Mm, Gg, Gg, Rd, Re^Gvs, Re^Gvs, Re^Gvs, Re^Gvs, Re^Gvs, Re^Gvs, Ww, Ww, Co, Co, Mm, Mm, Mm, Mm, Mm, Mm, Rd, Mm, Mm, Mm, Mm, Mm, Mm, Co, Co, Ww, Ww, Wwg, Wwg, Re, Re^Gvs, Re^Gvs, Rd, Re^Gvs, Rd, Rd, Re, Gg^Efm, Hh, Hh, Hh, Mm, Gg, Gg, Gg, Gg^Efm, Gg, Gg
Mm^Xm, Mm^Xm, Mm^Xm, Mm^Xm, Mm, Mm, Mm, Mm, Mm, Mm, Mm, Mm, Hh, Rd, Rd, Re^Gvs, Gg, Re^Gvs, Re^Gvs, Ww, Co, Co, Mm, Mm, Mm, Mm, Co, Mm, Mm^Vo, Mm, Rd, Mm, Mm^Vo, Mm, Co, Mm, Mm, Mm, Mm, Co, Co, Wwg, Wwg, Re, Rd, Rd, Re^Gvs, Rd, Gg, Gg, Gg, Re, Hh, Hh, Gg, Gg, Gg, Gg, Gg, Gg, Gg, Gg
Mm^Xm, Mm^Xm, Mm^Xm, Mm^Xm, Mm, Mm, Mm, Mm, Mm, Mm, Mm, Mm, Mm, Hh, Gg, Rd, Gs^Fp, Re^Gvs, Gg, Ww, Co, Mm, Mm, Mm, Co, Co, Co, Mm^Vo, Mm^Vo, Mm, Rd, Mm, Mm^Vo, Mm^Vo, Co, Co, Co, Mm, Mm, Mm, Co, Ww, Wwg, Rd, Re^Gvs, Gg, Re^Gvs, Re^Gvs, Re^Gvs, Re^Gvs, Re, Re, Re, Gg, Ce, Ce, Ce, Ce, Ce, Ce, Ce, Ce
Mm^Xm, Mm^Xm, Hh, Mm, Mm, Mm, Mm, Mm, Mm, Mm, Mm^Vhh, Mm, Mm^Vhh, Hh, Gg, Rd, Re^Gvs, Gg, Gg, Ww, Co, Mm, Mm, Co, Co, Ko, Co, Co, Mm^Vo, Mm^Vo, Rd, Mm^Vo, Mm^Vo, Co, Co, Ko, Co, Co, Mm, Mm, Co, Ww, Wwg, Rd, Re^Gvs, Re^Gvs, Gg^Efm, Re^Gvs, Re^Gvs, Re^Gvs, Re^Gvs, Gg, Ce, Ce, Gg^Vh, Gg, Gg^Vh, Gg, Gg^Vh, Gg, Gg^Vh, Gg
Hh, Hh, Hh, Mm, Mm, Mm, Mm, Mm^Vhh, Mm, Mm^Vhh, Mm, Mm, Mm, Mm, Gg, Rd, Re^Gvs, Re^Gvs, Re^Gvs, Ww, Co, Mm, Mm, Mm^Vo, Co, Co, Mm^Vo, Mm^Vo, Rd, Rd, Rd, Rd, Rd, Mm^Vo, Mm^Vo, Co, Co, Mm^Vo, Mm, Mm, Co, Ww, Wwg, Wwg, Re^Gvs, Re^Gvs, Re^Gvs, Re^Gvs, Re^Gvs, Re^Gvs, Gg, Gg, Ce, Gg, Gg, Gg, Gg, Gg, Gg^Vh, Gg, Gg^Vh, Gg
Hh, Hh, Hh, Mm, Mm, Mm, Mm, Mm, Mm^Vhh, Mm, Mm, Mm^Vhh, Mm, Mm, Ce, Rd, Re^Gvs, Re^Gvs, Rd, Ww, Co, Mm, Mm, Mm^Vo, Mm, Mm^Vo, Mm^Vo, Rd, Mm^Vo, Co, Co, Co, Mm^Vo, Rd, Mm^Vo, Mm^Vo, Mm, Mm^Vo, Mm, Mm, Co, Ww, Wwg^Bw/, Rd, Re, Re^Gvs, Re^Gvs, Re^Gvs, Re, Gg, Re, Gg, Ce, Gg^Vh, Gg, Ce, Ce, Ce, Gg^Efm, Gg, Gg, Gg
Hh, Hh, Hh, Hh, Hh, Mm, Mm, Mm^Vhh, Hh^Vhh, Mm, Ce, Mm, Ce, Gg, Ce, Rd, Re^Gvs, Re, Rd, Ww^Bw\, Rd, Rd, Rd, Rd, Rd, Rd, Rd, Rd, Rd, Co, 4 Ko, Co, Rd, Rd, Rd, Rd, Rd, Rd, Rd, Rd, Rd, Ww^Bw/, Wwg, Re, Re, Re, Re, Re, Re^Gvs, Re, Re^Gvs, Re, Rd, Gg, Gg, Ce, 1 Ke, Ce, Gg^Efm, Gg^Vh, Gg, Gg
Re, Re, Re, Re, Re, Re, Re, Re, Re, Hh, Ce, Ce, Ce, Gg, Ce, Rd, Rd, Rd, Rd, Ww^Bw/, Co, Rd, Mm, Rd, Mm, Rd, Mm^Vo, Rd, Mm^Vo, Co, Co, Co, Mm^Vo, Rd, Mm^Vo, Rd, Mm, Rd, Mm, Rd, Co, Ww^Bw\, Wwg^Bw\, Re, Re^Gvs, Re^Gvs, Re^Gvs, Gg^Efm, Re^Gvs, Re^Gvs, Re^Gvs, Rd, Ce, Gg, Gg, Ce, Ce, Ce, Gg^Vh, Gg, Gg^Vh, Gg
Hh, Hh, Mm, Hh, Mm, Hh, Mm, Hh^Vhh, Hh, Re, Ce, 2 Ke, Ce, Re, Re, Re, Rd, Re^Gvs, Re^Gvs, Ww, Co, Mm, Mm, Mm^Vo, Co, Mm^Vo, Mm^Vo, Rd, Rd, Co, Rd, Co, Rd, Rd, Mm^Vo, Mm^Vo, Co, Mm^Vo, Mm, Mm, Co, Ww, Wwg, Rd, Re^Gvs, Re^Gvs, Re^Gvs, Re^Gvs, Re^Gvs, Re^Gvs, Rd, Rd, Ce, Gg, Gg, Ce, Gg^Vh, Ce, Gg, Gg, Gg, Gg
Mm, Mm, Mm, Mm, Mm, Mm, Mm, Mm^Vhh, Mm, Hh^Vhh, Ce, Ce, Ce, Gg, Ce, Re^Gvs, Re^Gvs, Rd, Re^Gvs, Ww, Co, Mm, Mm, Mm^Vo, Co, Co, Co, Mm^Vo, Mm^Vo, Rd, Rd, Rd, Mm^Vo, Mm^Vo, Co, Co, Co, Mm^Vo, Mm, Mm, Co, Ww, Wwg, Rd, Re^Gvs, Re^Gvs, Re^Gvs, Re^Gvs, Re^Gvs, Rd, Re^Gvs, Re^Gvs, Ce, Gg^Vh, Gg, Gg, Gg, Gg, Gg, Gg^Vh, Gg, Gg
Mm, Mm, Mm, Mm, Mm, Mm, Mm, Mm, Mm^Vhh, Hh, Hh^Vhh, Gll^Fp, Gll^Fp, Gll^Fp, Ce, Re^Gvs, Re^Gvs, Rd, Rd, Ww, Co, Mm, Mm, Co, Co, Ko, Co, Co, Mm^Vo, Mm^Vo, Rd, Mm^Vo, Mm^Vo, Co, Co, Ko, Co, Co, Mm, Mm, Co, Ww, Wwg, Rd, Rd, Re^Gvs, Re^Gvs, Re^Gvs, Gg^Efm, Rd, Re^Gvs, Re^Gvs, Gg, Ce, Ce, Gg^Vh, Ce, Gg^Vh, Ce, Gg^Vh, Ce, Ce
Mm, Mm, Mm^Xm, Mm, Mm, Mm, Mm, Mm^Vhh, Mm^Vhh, Mm, Mm, Mm, Mm, Hh, Ce, Re^Gvs, Re^Gvs, Rd, Re^Gvs, Ww, Co, Mm, Mm, Mm, Mm, Co, Co, Mm^Vo, Mm^Vo, Mm, Rd, Mm^Vo, Mm, Mm, Co, Co, Mm, Mm, Mm, Mm, Co, Ww, Wwg, Re^Gvs, Gg, Rd, Rd, Re^Gvs, Re^Gvs, Rd, Re, Re, Re, Gg, Gg, Ce, Re, Ce, Re^Gvs, Ce, Re^Gvs, Re^Gvs
Mm^Xm, Mm^Xm, Mm^Xm, Mm^Xm, Mm, Mm, Mm, Mm, Mm, Mm, Mm^Vhh, Mm^Vhh, Mm, Hh, Gg, Re^Gvs, Re^Gvs, Rd, Re, Ww, Ww, Co, Co, Mm, Mm, Mm, Mm, Mm, Mm, Mm, Rd, Mm, Mm, Mm, Mm, Mm, Mm, Mm, Co, Co, Ww, Wwg, Wwg, Re^Gvs, Re^Gvs, Re^Gvs, Re, Rd, Rd, Rd, Re^Gvs, Re^Gvs, Re^Gvs, Re, Re, Re, Re^Gvs, Re^Gvs, Re^Gvs, Re^Gvs, Re^Gvs, Re^Gvs
Mm^Xm, Mm^Xm, Mm^Xm, Mm^Xm, Mm, Mm, Mm, Mm, Mm, Mm, Mm, Mm, Mm, Hh, Hh, Re^Gvs, Rd, Gd^Vo, Gg, Re, Gg, Ww, Ww, Co, Co, Mm, Mm, Mm, Mm, Mm, Rd, Mm, Mm, Mm, Mm, Mm, Co, Co, Ww, Ww, Wwg, Wwg, Re, Re^Gvs, Re^Gvs, Re^Gvs, Re^Gvs, Rd, Gg^Efm, Re^Gvs, Re^Gvs, Re^Gvs, Gg^Efm, Re^Gvs, Re^Gvs, Re, Re, Re^Gvs, Re^Gvs, Re^Gvs, Re^Gvs, Re^Gvs
Mm^Xm, Mm^Xm, Mm^Xm, Mm^Xm, Mm, Mm, Mm, Mm, Mm, Mm, Hh, Mm, Hh, Hh, Rd, Rd, Re^Gvs, Gg, Re^Gvs, Gg, Re^Gvs, Re^Gvs, Ww, Ww, Ww, Co, Co, Mm, Co, Mm, Rd, Mm, Co, Mm, Co, Co, Ww, Ww, Wwg, Wwg, Re, Gg^Efm, Re^Gvs, Re^Gvs, Re^Gvs, Re^Gvs, Rd, Rd, Re^Gvs, Re^Gvs, Gg^Efm, Re^Gvs, Gg^Efm, Re^Gvs, Gg, Gg, Re, Re, Re^Gvs, Re^Gvs, Re^Gvs, Re^Gvs
Mm^Xm, Mm^Xm, Mm^Xm, Mm^Xm, Mm, Mm, Mm, Mm, Mm, Mm, Hh, Hh, Gs^Fp, Gg, Rd, Re^Gvs, Hh, Re^Gvs, Re^Gvs, Re^Gvs, Re^Gvs, Re^Gvs, Wo, Ww, Wwg, Ww, Ww, Co, Ww, Co, Ww^Bw|, Co, Ww, Co, Ww, Ww, Wwg, Wwg, Rd, Rd, Gd^Vo, Re, Rd, Re^Gvs, Rd, Rd, Gg, Re, Re, Re^Gvs, Re^Gvs, Re^Gvs, Re^Gvs, Gg, Re^Gvs, Re^Gvs, Re, Re^Gvs, Re, Re^Gvs, Re^Gvs, Re^Gvs
Mm^Xm, Mm^Xm, Mm^Xm, Mm^Xm, Mm, Mm, Mm, Mm, Mm, Hh, Hh, Hh, Gs^Fp, Gg, Rd, Re^Gvs, Re^Gvs, Re^Gvs, Wo, Wo, Wo, Wo, Re^Gvs, Re^Gvs, Re, Wwg, Wwg, Ww, Wwg, Ww, Wwg^Bw|, Ww, Wwg, Wwg, Wwg, Wwg, Re^Gvs, Rd, Re^Gvs, Re^Gvs, Re^Gvs, Rd, Re^Gvs, Rd, Re^Gvs, Re, Re^Gvs, Re^Gvs, Re^Gvs, Gd^Vo, Re, Gg, Re^Gvs, Re^Gvs, Re^Gvs, Re^Gvs, Re, Gg, Gg^Efm, Re, Re, Re
Mm^Xm, Mm^Xm, Mm, Mm, Mm, Mm, Mm, Mm, Mm, Mm, Mm, Gg, Gg, Gg, Rd, Re^Gvs, Re^Gvs, Re^Gvs, Wo, Gg, Re^Gvs, Re^Gvs, Re^Gvs, Re^Gvs, Re, Re^Gvs, Re^Gvs, Wwg, Re^Gvs, Re^Gvs, Rd, Wwg, Re^Gvs, Re^Gvs, Re, Re, Re^Gvs, Re^Gvs, Gll^Fp, Re^Gvs, Gll^Fp, Gg, Re^Gvs, Re^Gvs, Re^Gvs, Re, Re^Gvs, Re^Gvs, Re^Gvs, Re^Gvs, Re^Gvs, Re, Re, Re^Gvs, Re, Re^Gvs, Gg, Gg, Gg, Gg, Gg, Gg
Mm, Mm, Mm, Mm, Mm, Mm, Mm, Mm, Hh, Mm, Re^Gvs, Gg, Re^Gvs, Gg, Re, Rd, Rd, Wo, Ww, Re, Re^Gvs, Re^Gvs, Re^Gvs, Re^Gvs, Re, Re^Gvs, Re^Gvs, Re^Gvs, Re^Gvs, Re^Gvs, Rd, Re^Gvs, Re^Gvs, Rd, Re^Gvs, Re^Gvs, Re^Gvs, Re^Gvs, Gll^Fp, Gll^Fp, Gll^Fp, Gll^Fp, Gg, Re^Gvs, Re^Gvs, Re, Re^Gvs, Re^Gvs, Re^Gvs, Re^Gvs, Re^Gvs, Gg, Gg, Re, Gg, Gg, Gg, Gg, Gg, Gg, Gg, Gg
Mm, Mm, Mm, Mm, Hh, Hh, Hh, Hh, Hh, Re^Gvs, Re^Gvs, Re^Gvs, Re, Re, Gg, Gg, Gg, Wo^Bw\, Re, Re^Gvs, Re^Gvs, Re, Gd^Vo, Re^Gvs, Gg, Re^Gvs, Re, Re^Gvs, Re^Gvs, Re, Rd, Re^Gvs, Re^Gvs, Rd, Gll^Fp, Gll^Fp, Gll^Fp, Gll^Fp, Gll^Fp, Gll^Fp, Gll^Fp, Gll^Fp, Gg, Gg^Efm, Re^Gvs, Re, Re, Gg, Re^Gvs, Re^Gvs, Re^Gvs, Gg, Gg, Gg, Gll^Fp, Gg, Gll^Fp, Gll^Fp, Gll^Fp, Gg, Gg, Gg
Mm, Mm, Mm, Hh, Hh, Hh, Gs^Fp, Gs^Fp, Re^Gvs, Re^Gvs, Re^Gvs, Re, Gll^Fp, Gs^Fp, Gs^Fp, Gs^Fp, Wo, Wo, Re, Rd, Rd, Rd, Re^Gvs, Rd, Rd, Rd, Rd, Re, Rd, Rd, Re, Re^Gvs, Rd, Rd, Gg, Gll^Fp, Gll^Fp, Gg^Fet, Gll^Fp, Gg^Fet, Gll^Fp, Gll^Fp, Gll^Fp, Gg, Gll, Gg^Efm, Re, Re, Gg, Gg, Gll^Fp, Gg, Gll^Fp, Gll^Fp, Gll^Fp, Gll^Fp, Hh, Gll^Fp, Hh, Gll^Fp, Gg, Gg
Mm, Mm, Mm, Mm, Mm, Hh, Hh, Gs^Fp, Re^Gvs, Re^Gvs, Gd^Vo, Gll, Gll^Fp, Gg^Fet, Wo, Wo, Gll^Fp, Gll^Fp, Gg, Re, Gg, Re^Gvs, Gll^Fp, Gll^Fp, Gll^Fp, Gll^Fp, Gll^Fp, Rd, Gll^Fp, Gll^Fp, Gll^Fp, Re, Rrd, Gg^Efm, Gg, Gg, Gll^Fp, Gll^Fp, Gll^Fp, Gll^Fp, Gll^Fp, Gll^Fp, Gll^Fp, Gll^Fp, Gg, Gg, Gd^Vo, Re, Gll, Gg, Gll^Fp, Gll^Fp, Gll^Fp, Hh, Hh, Hh, Hh, Gll^Fp, Hh, Hh, Gg, Gg
Mm, Mm, Mm, Mm, Mm, Hh, Hh, Hh, Hh, Re^Gvs, Re^Gvs, Re, Wo, Wo, Gll^Fp, Gll^Fp, Gg^Fet, Gll^Fp, Gll, Gll, Gll^Fp, Gll^Fp, Gll^Fp, Gll^Fp, Hh, Hh, Hh, Gll^Fp, Gll^Fp, Gll^Fp, Gll^Fp, Gg, Rrd, Gg, Gll^Fp, Gll^Fp, Gll^Fp, Gll^Fp, Gll^Fp, Gll^Fp, Gll^Fp, Gll^Fp, Gll^Fp, Gll^Fp, Gll, Gg, Re, Re, Gg, Gll^Fp, Gll^Fp, Hh, Hh, Hh, Hh, Hh, Hh, Hh, Hh, Gg, Gg, Gg
Mm, Mm, Ww, Mm, Mm, Mm, Mm, Mm, Mm, Hh, Re^Gvs, Re^Gvs, Wo, Wo, Gg, Gll^Fp, Gll^Fp, Gll^Fp, Gg, Gll^Fp, Gll, Gg^Fet, Hh, Hh, Hh, Hh, Hh, Hh, Hh, Gll^Fp, Gll^Fp, Gll^Fp, Rrd, Gg^Efm, Gg^Efm, Gll^Fp, Gll^Fp, Gg^Fet, Gll^Fp, Gll^Fp, Gll^Fp, Gg^Fet, Gll^Fp, Gll^Fp, Gg, Gll, Re, Gg, Gll^Fp, Gll^Fp, Gll^Fp, Hh, Gll^Fp, Hh, Gll^Fp, Gll^Fp, Hh, Hh, Gll^Fp, Gll^Fp, Gll^Fp, Gll^Fp
Ww, Ww, Mm, Ww, Mm, Mm, Mm, Mm, Mm, Mm, Gg, Gg, Wo, Gg, Gg^Efm, Gg^Efm, Gll^Fp, Gg, Gg, Gll^Fp, Gll^Fp, Gll^Fp, Gll^Fp, Gll^Fp, Hh, Hh, Hh, Hh, Hh, Gll^Fp, Gg^Fet, Gll^Fp, Rrd, Gll^Fp, Gg^Efm, Gll^Fp, Gll^Fp, Gll^Fp, Gg^Efm, Gg, Gll^Fp, Gll^Fp, Gll^Fp, Gll, Gll, Gg, Re, Gg, Gll, Gll^Fp, Gll^Fp, Gll^Fp, Gll^Fp, Gll^Fp, Gll^Fp, Gll^Fp, Hh, Gg, Gll^Fp, Gll^Fp, Gg, Gg
Mm, Mm, Mm, Ww, Mm, Mm, Mm, Mm, Mm, Mm, Hh, Wo, Wo, Gg^Efm, Gll, Gll, Gll^Fp, Gll^Fp, Gll^Fp, Gll^Fp, Gll^Fp, Gll^Fp, Gg^Fet, Gll^Fp, Gll^Fp, Hh, Gll^Fp, Hh, Hh, Gll^Fp, Gll^Fp, Gll^Fp, Rrd, Gll^Fp, Gll^Fp, Gg^Efm, Gg^Efm, Gg^Efm, Gll^Fp, Gg^Efm, Gg^Efm, Gll^Fp, Gg, Gll^Fp, Gll^Fp, Gll^Fp, Re, Gll, Gll, Gll^Fp, Gll^Fp, Gll^Fp, Gll^Fp, Gll^Fp, Gll^Fp, Gll^Fp, Gll^Fp, Gll^Fp, Gll^Fp, Gg, Gg, Gg
Mm, Mm, Mm, Ww, Ww, Mm, Mm, Mm, Mm, Mm, Wo, Wo, Gg^Efm, Gg^Efm, Gll^Fp, Gll^Fp, Gll^Fp, Gll^Fp, Gll^Fp, Gg^Fet, Gll^Fp, Gll^Fp, Gll^Fp, Gll^Fp, Gll^Fp, Gll^Fp, Gll^Fp, Gll^Fp, Gll^Fp, Gll^Fp, Gll^Fp, Gll^Fp, Gll^Fp, Gll^Fp, Gll^Fp, Gll^Fp, Gg^Efm, Gll^Fp, Gll^Fp, Gg, Gg, Gg^Efm, Re, Re, Re, Re, Gll^Fp, Gll, Gg, Gll^Fp, Gll^Fp, Gll^Fp, Gll^Fp, Gll^Fp, Gll^Fp, Gll^Fp, Gg, Gll^Fp, Gg, Gg, Gg, Gg
Mm, Mm, Mm, Mm, Mm, Ww, Ww, Mm, Mm, Hh, Wo, Gg, Gll^Fp, Gg, Gg^Fet, Gll^Fp, Gll^Fp, Gg^Fet, Gll^Fp, Gll^Fp, Hh, Gll^Fp, Gll^Fp, Gll^Fp, Rrd, Rrd, Dd^Vdt, Gll^Fp, Rrd, Gll^Fp, Rrd, Rrd, Gll^Fp, Gg^Efm, Gg^Efm, Gg^Ve, Gll^Fp, Gll^Fp, Hh, Hh, Re, Re, Hh, Gs^Fp, Hh, Hh, Gll^Fp, Gll^Fp, Gll^Fp, Gg, Gll^Fp, Gll^Fp, Gll^Fp, Gll^Fp, Gg, Gll^Fp, Gg, Gg, Gg, Gg, Gg, Gg
Mm, Mm, Mm, Mm, Mm, Mm, Hh, Ww, Hh, Hh, Wo, Gll^Fp, Gll^Fp, Gll^Fp, Gll^Fp, Gll^Fp, Hh, Gll^Fp, Hh, Hh, Hh, Hh, Hh, Gg^Fet, Gll^Fp, Dd^Vdt, Ce, Ce, Gg^Efm, Dd^Vdt, Gg^Efm, Gg^Efm, Gg, Gll^Fp, Gll^Efm, Gll^Efm, Gll^Fp, Gg^Fet, Gll^Fp, Re, Re, Hh, Hh, Hh, Hh, Hh, Gll^Fp, Gll^Fp, Gll^Fp, Gg, Gg, Gll^Fp, Gg, Gg, Gd^Vo, Gg, Gll^Fp, Gll^Fp, Gll^Fp, Gll^Fp, Gll^Fp, Gll^Fp
Mm, Mm, Mm, Mm, Mm, Hh, Ww, Wo, Wo, Wo, Gg, Gll^Fp, Gll^Fet, Gll^Fp, Gll^Fp, Gll^Fp, Gll, Hh, Hh, Hh, Gll^Fp, Hh, Gll^Fp, Gg^Efm, Gll^Efm, Ce, 6 Ke, Gg^Efm, Gll^Efm, Gs, Co, Co, Co, Gs, Dd^Vdt, Gll^Efm, Gll^Fp, Gll^Fp, Re, Re, Hh, Hh, Hh, Hh, Gll^Fp, Gll^Fp, Gll^Fp, Gll^Fp, Gll^Fp, Gg, Gg, Gll^Fp, Gg, Gg, Gg, Gg, Gll^Fp, Gll^Fp, Gll^Fp, Gll^Fp, Gll^Fp, Gll^Fp
Mm, Mm, Mm, Mm, Mm, Hh, Ww, Ww, Gg^Fet, Gg, Gd^Vo, Gg, Gll^Fp, Gll^Fp, Gll^Fp, Gll, Gll^Fp, Gll^Fp, Hh, Gll^Fp, Gll^Fp, Gg^Fet, Gll^Fp, Gll^Fp, Gll^Efm, Ce, Dd^Vdt, Gll^Efm, 7 Gg, Gs, Co, 5 Ko, Co, Gs, Gg^Efm, Re, Gll^Fp, Re, Hh, Hh, Gll^Fp, Hh, Gll^Fp, Hh, Gll^Fp, Gll^Fp, Gll^Fp, Gll^Fp, Gg^Fet, Gll^Fp, Gll^Fp, Gg, Gll^Fp, Gll^Fp, Gll^Fp, Gll^Fp, Gll^Fp, Gll^Fp, Gll^Fp, Gll^Fp, Gll^Fp, Gll^Fp
Mm, Mm, Mm, Mm, Mm, Ww, Ww, Gg^Fet, Gll^Fp, Gll^Fp, Gll, Gg^Efm, Gll^Fp, Gll^Fp, Gll^Fp, Gll^Fp, Gll^Fp, Gll^Fp, Gll^Fp, Gll^Fp, Gll^Fp, Gs^Vl, Gs, Gll^Fp, Gg^Fet, Gg^Efm, Rrd, Gg^Efm, Gg^Efm, Gs, Gs, Co, Gs, Gs, Dd^Vdt, Gll^Fp, Gll^Fp, Re, Hh, Gll^Fp, Gll^Fp, Gll^Fp, Gll^Fp, Gll^Fp, Gg, Gll^Fp, Gll^Fp, Gll^Fp, Gll^Fp, Gll^Fp, Gll^Fp, Gg, Gll^Fp, Gll^Fp, Gll^Fp, Gll^Fp, Gll^Fp, Gll^Fp, Gll^Fp, Gll^Fp, Gg, Gg
Mm, Mm, Mm, Mm, Mm, Ww, Gg, Gll^Fp, Gll^Fp, Gll^Fp, Gll^Efm, Gll^Efm, Gll, Gll^Fp, Gg^Fet, Gll^Fp, Gll^Fp, Gll^Fp, Gll^Fp, Gg^Fet, Gll^Fp, Gll^Fp, Gll^Fp, Gll^Fp, Gll^Fp, Gg^Efm, Rrd, Gll^Fp, Gll^Fp, Gll^Fp, Gll^Fp, Gg^Efm, Gg^Efm, Gg^Efm, Gg^Efm, Gll^Fp, Gll^Fp, Re, Gll^Fp, Gll^Fp, Gll^Fp, Gll^Fp, Gll^Fp, Gll^Fp, Gll^Fp, Gg^Fet, Gll^Fp, Gll^Fp, Gll^Fp, Gll^Fp, Gll^Fp, Gll^Fp, Gg, Gll^Fp, Gll^Fp, Gll^Fp, Gll^Fp, Gll^Fp, Hh, Hh, Hh, Hh
Hh, Hh, Hh, Mm, Ww, Ww, Gg, Gll^Fp, Gll^Fp, Gll^Fp, Gg^Efm, Gll, Gll^Fp, Gll^Fp, Gll^Fp, Gll^Fp, Gll^Fp, Gll^Fet, Gll^Fp, Gll^Fp, Gll^Fp, Gg^Fet, Gll^Fp, Gll^Fp, Gg^Ve, Gll^Fp, Rrd, Gs^Vl, Gll^Fp, Gll^Fp, Gg^Fet, Gll^Fp, Gg^Fet, Gg^Ve, Gg^Efm, Gg, Re, Gs^Vl, Gll^Fp, Gll^Fp, Gg^Fet, Gll^Fp, Gg^Fet, Gll^Fp, Gll^Fp, Gll^Fp, Gll^Fp, Gll^Fp, Gg^Fet, Gll^Fp, Gll^Fp, Gll^Fp, Gll^Fp, Gg, Gll^Fp, Gll^Fp, Hh, Hh, Hh, Hh, Hh, Hh
Hh, Hh, Hh, Ww, Gll^Fp, Gg^Fet, Gll^Fp, Gg, Gll, Gg, Gg, Gll^Fp, Gll^Fp, Gll^Fp, Gll^Fp, Gll^Fp, Gll^Fet, Gll^Fp, Gll^Fp, Hh, Hh, Hh, Gll^Fp, Gll^Fp, Gll^Fp, Gll^Fp, Re, Gll^Fp, Gll^Fp, Gll^Fp, Hh, Gll^Fp, Gll^Fp, Gg^Efm, Gg, Gll, Gll^Fp, Gll^Fp, Gll^Fp, Gll^Fp, Gll^Fp, Gll^Fp, Gll^Fp, Gll^Fp, Gll^Fp, Gll^Fp, Gll^Fp, Gll^Fp, Gll^Fp, Gg^Fet, Gll^Fp, Gll^Fp, Gll^Fp, Gll^Fp, Gll^Fp, Hh, Hh, Hh, Mm, Hh, Mm, Mm
Hh, Hh, Ww, Ww, Gll^Fp, Gll^Fp, Gll^Fp, Gll, Gg, Gg, Gll^Fp, Gll^Fp, Gll^Fp, Gll^Fp, Gll^Fp, Gll^Fp, Gll^Fp, Gll^Fp, Hh, Hh, Hh, Gll^Fp, Hh, Gll^Fp, Gll^Fp, Gll^Fp, Hh, Rrd, Rrd, Hh, Hh, Gll^Fp, Hh, Gg, Gll, Gll^Fp, Gll, Gll^Fp, Gll^Fp, Gll^Fp, Gll^Fp, Gll^Fp, Gll^Fp, Gll^Fp, Gg^Fet, Gll^Fp, Gll^Fp, Gll^Fp, Gll^Fp, Gll^Fp, Gll^Fp, Gll^Fp, Gll^Fp, Gg, Gll^Fp, Hh, Hh, Hh, Mm, Mm, Mm, Mm
Ww, Ww, Gll^Fp, Gll^Fp, Gll^Fp, Gll^Fp, Gll, Gg, Gg, Gll^Fp, Gll^Fp, Gll^Fp, Gll^Fp, Gll^Fp, Gll^Fp, Gll^Fp, Gll^Fp, Hh, Hh, Hh, Hh, Hh, Hh, Hh, Hh, Hh, Hh, Hh, Hh, Rrd, Rrd, Hh, Gs^Fp, Gg, Gg, Gg, Gll^Fp, Gll^Fp, Gll^Fp, Gg^Fet, Gll^Fp, Gll^Fp, Gll^Fp, Gll^Fp, Gll^Fp, Gll^Fp, Gll^Fp, Gll^Fp, Gll^Fp, Gll^Fp, Gll^Fp, Gll^Fp, Gll^Fp, Gg, Hh, Gll^Fp, Hh, Hh, Mm, Mm, Mm, Mm
Ww, Ww, Gll^Fp, Gll^Fp, Gll^Fp, Gll^Fp, Gg, Gg, Gg, Gll^Fp, Gll^Fp, Gll^Fp, Gll^Fp, Gll^Fp, Gll^Fp, Gll^Fp, Gll^Fp, Hh, Hh, Hh, Hh, Hh, Hh, Hh, Hh, Hh, Hh, Hh, Hh, Hh, Hh, Rrd, Gs^Fp, Gg, Gg, Gg, Gll^Fp, Gll^Fp, Gll^Fp, Gll^Fp, Gll^Fp, Gll^Fp, Gll^Fp, Gll^Fp, Gll^Fp, Gll^Fp, Gll^Fp, Gll^Fp, Gll^Fp, Gll^Fp, Gll^Fp, Gll^Fp, Gll^Fp, Gg, Hh, Gll^Fp, Hh, Hh, Mm, Mm, Mm, Mm
