Xu, Xu, Uu, Xu, Xu, Xu, Xu, Uu, Xu, Xu, Xu, Xu, Ai, Ms, Ms, Ms, Ms, Xu, Aa, Xu, Ms, Xu, Ms, Xu, Ai, Aa, Ai, Ai, Ai, Ai, Ai, Xu, Xu, Xu, Uue, Xu, Xu, Xu, Xu, Uu, Xu, Uu
Xu, Xu, Uu, Xu, Xu, Xu, Xu, Uu, Xu, Xu, Xu, Xu, Ai, Ai, Ms, Ms, Ms, Ms, Ai, Aa^Vaa, Ms, Ms, Ms, Ms, Ai, Ai, Ai, Ai, Ai, Ai, Ai, Xu, Xu, Xu, Uue, Xu, Xu, Xu, Uu, Uu, Xu, Xu
Xu, Xu, Uu, Xu, Xu, Xu, Xu, Uu, Xu, Xu, Xu, Xu, Xu, Ai, Ai, Ai, Ai, Ai, Ai, Ai^Bsa|, Ai, Ai, Ai, Ai, Xu, Ai, Ai, Ai, Ai, Ai, Xu, Xu, Xu, Xu, Uue, Xu, Xu, Xu, Uu, Xu, Xu, Xu
Xu, Xu, Xu, Uu, Uu, Xu, Uu, Uu, Xu, Xu, Xu, Xu, Xu, Xu, Xu, Ai, Aa, Aa, Xu, Aa^Ii, Xu, Ai, Xu, Xu, Xos, Ai, Ai, Ai, Ai, Ai, Ai, Xu, Xu, Xu, Uue, Xu, Xu, Xu, Uu, Xu, Uue, Uue
Xu, Xu, Xu, Xu, Xu, Uu, Xu, Uu, Uu, Xu, Xu, Xu, Xu, Xu, Xu, Ai, Ai, Xos, Xor, Aa^Ii, Cud, Xu, Xor, Xor, Xor, Wo, Xor, Ai, Xor, Xu, Ai, Xu, Xor, Uue, Uu, Xu, Xu, Uu^Vu, Xu, Uue, Uue, Xu
Xu, Xu, Xu, Xu, Xu, Uu, Xu, Xu, Xu, Uu, Uu, Xu, Uu, Xor, Xor, Xor, Wo, Xor, Uu^Vud, Ur, Ur, Xor, Ur, Uu^Vud, Wo^Bw\, Wo, Uu, Xor, Uu, Xor, Uu, Ai, Uhe, Uhe, Uu, Uu, Uue, Uue, Uue, Uue, Xu, Xu
Xu, Xu, Xu, Xu, Xu, Uu, Xu, Xu, Xu, Xu, Xu, Rb, Rb, Uh, Uh, Uh, Uh, Wo, Rr, Rr^Ii, Ww, Ur, Uu^Vud, Wo, Wo, Ur, Ur, Uu, Ww, Uu, Ww, Ww, Ww, Uh, Xue, Xue, Xue, Xu, Xu, Uue, Uue, Uue
Xu, Xu, Xu, Xu, Xu, Uu, Uu, Uu, Uu, Xu, Xu, Xu, Rb, Uh, Uu^Vud, Uu, Rr, Wo^Bw/, Wo, Ww, Ww, Ww, Wo, Ww, Wo, Ww, Ww, Ww^Bw\, Ur, Ww, Uh, Ww, Uh, Uu, Uu, Xue, Xue, Xue, Xu, Xu, Xu, Xu
Xu, Xu, Xu, Xu, Xu, Uu^Vu, Xu, Xu, Xu, Uu, Uh, Uh, Uu, Uh, Uh, Uh, Rb, Uu, Ww, Ww, Ww, Wo, Wo, Wo, Ww, Ww, Ww, Uu, Ur, Uh, Uh, Uu^Vud, Uh, Uh, Uu, Xue, Xu, Xu, Xu, Xu, Xu, Xu
Xu, Xu, Xu, Xu, Xu, Xu, Xu, Xu, Xu, Xu, Xu, Uh, Uu, Uh, Rb, Uh, Rb, Uu, Ww, Ww, Ww, Ww, Ww, Ww, Ww, Ww, Ww, Uu^Vud, Ur, Uh, Rb, Uh, Xu, Uh, Uu, Uhe, Uhe, Xu, Xu, Xu, Xu, Xu
Xu, Xu, Xu, Xu, Xu, Xu, Xu, Xu, Xu, Xu, Xu, Xu, Uu, Uu, Tb^Ii, Rb, Uu, Rb, Ww, Ww, Ww, Uh, Uu, Uh, Uh, Ww, Ww, Ww, Ww, Ur, Ur, Xu, Xu, Uu, Uhe, Uhe, Xur, Xu, Xu, Xu, Xu, Xu
Xu, Xu, Xu, Xu, Xu, Xu, Xu, Xu, Rr, Xor, Rr, Uu, Uu^Vud, Uh, Uu, Rb, Rr, Uu^Vud, Ww, Ww, Uu, Uu^Ecf, Ce, Uu, Uu, Uh, Uh, Uu, Uh, Ur, Uh, Uu, Uu, Uu, Uu, Xur, Xur, Xur, Xu, Xu, Xu, Xu
Rr, Xu, Rr, Xu, Rr, Rr, Rr, Rr, Rr, Rr, Xu, Rr, Rr, Uh, Rr, Rr, Uu, Uh, Ww, Uu, Ce, Ce, 1 Ke, Ce, Rb, Rb, Rb, Rb, Rb, Ur, Rb^Emf, Uu, Uu, Uu, Uu, Uu, Uu, Xu, Xu, Xu, Uu, Uu
Uu, Rr, Xu, Rr, Xu, Xu, Xu, Xu, Xu, Xor, Xu, Xu, Xu, Rb, Uu, Uu, Uu, Uu, Ww, Uu, Uu, Ce, Ce, Ce, Uh, Rb, Uh, Uu, Ur, Ur, Xu, Uu, Uu, Uu, Uu, Xu, Xu, Uu, Xu, Uu, Uu, Xu
Uu, Uu, Uu, Xu, Xu, Xu, Xu, Xu, Xu, Xu, Xu, Xu, Xu, Xu, Uu, Uu, Wo, Wo, Uu, Uu, Uu, Uu, Uu, Uu, Uh, Uh, Ur, Uu^Vud, Ur, Uh, Xu, Xu, Uh, Uu, Uu, Xu, Xur, Uu, Uu, Uu, Xu, Xu
Xu, Xu, Xu, Uu, Uu, Xu, Uu, Xu, Xu, Xor, Uu, Uu, Uu, Uu, Uu^Emf, Uu, Wo, Uu^Vud, Uh, Uh, Xu, Uu, Uu, Uh, Uu, Uh, Rb, Rb^Emf, Ur, Uh, Uu, Uu^Vud, Uu, Uu, Uh, Uhe, Xu, Xu, Xu, Uu, Xu, Xu
Xu, Xu, Xu, Xu, Xu, Uu, Xu, Uu, Uu, Xu, Xu, Uu, Rb, Uu^Vud, Uu, Uh, Wo, Uh, Uh, Uu, Xu, Xu, Ur, Ur, Ur, Uu, Xu, Uu, Uh, Ur, Uu, Uu, Uu, Uu, Uu, Uhe, Uue, Xu, Xu, Xu, Xu, Xu
Xu, Xu, Xu, Xu, Xu, Xu, Xu, Xu, Xu, Uu, Uu, Uu, Rb, Uh, Uh, Ww, Wo, Uh, Uu, Uu, Uu, Uh, Uu^Vud, Xu, Xu, Xu, Xu, Xu, Uh, Ur, Ur, Uu, Xu, Uu, Uue, Xu, Uue, Uhe, Xu, Xu, Xu, Xu
Xu, Xu, Xu, Xu, Xu, Xu, Xu, Xu, Xu, Xu, Uu, Uu, Uh, Uu, Uh, Wo, Uh, Uu^Vud, Uh, Uu, Ur, Ur, Uu, Xu, Xu, Xu, Xu, Xu, Uh, Uh, Ur, Xu, Xu, Uh, Uh, Uue, Xu, Uue, Xu, Xu, Xu, Xu
Xu, Xu, Xu, Xu, Xu, Xu, Xu, Xu, Xu, Xor, Xu, Uh, Xu, Uu, Wo, Wo, Uh, Xu, Xu, Uu, Ur, Uu, Xu, Xu, Xu, Xu, Xu, Xu, Xu, Uh, Uu^Vud, Uu, Uh, Uu, Uu, Xu, Xu, Uue, Uue, Xu, Xu, Xu
Xu, Xu, Xu, Xu, Xu, Xu, Xu, Xu, Xu, Xor, Xu, Xu, Ww, Wo, Wo, Uh, Uu, Xu, Xor, Xu, Ur, Xu, Xu, Xu, Uu^Vud, Xu, Xu, Xu, Uh, Uu, Ur, Uh, Uh, Xu, Xu, Uu, Uu, Xu, Uue, Uue, Xu, Xu
Xu, Xu, Uu, Xu, Xu, Xu, Xu, Xu, Xu, Xor, Xu, Xu, Wo, Wo, Uh, Wwg, Wwg, Xu, Wwg, Xu, Ur, Xu, Xu, Xor, Xu, Uu, Uu, Uh, Xu, Uu, Ur, Uu, Xu, Xu, Xu, Xu, Xu, Uu, Uu, Uue, Uu, Xu
Uu, Uu, Xu, Uu, Uu, Uu, Uu, Xu, Xu, Xu, Wo, Wo, Xor, Uu^Vu, Xor, Xu, Wwg, Wwg, Wwg, Xu, Ur, Xu, Xu, Xu, Xu, Xu, Xu, Xu, Xu, Xu, Xu, Uh, Xu, Xu, Xu, Xu, Xu, Xu, Uu, Uu, Xu, Uu
Xu, Xu, Xu, Xu, Xu, Xu, Xu, Uu, Uu, Wo, Xu, Xu, Xu, Xor, Xu, Xu, Wwg, Wwg, Wwg, Xu, Ur, Uu^Vud, Xu, Xu, Xu, Xu, Xu, Xor, Xor, Xu, Uu, Ur, Xu, Xu, Xu, Xu, Xu, Uu, Xu, Xu, Xu, Xu
Xu, Xu, Xu, Xu, Xu, Xu, Uu, Uu, Wo, Wo, Uu, Xu, Xu, Xu, Xu, Xu, Xu, Wwg, Wwg, Xu, Ur, Xu, Xu, Xu, Xu, Xu, Xu, Xu, Xu, Xor, Xor, Ur, Ur, Xu, Xu, Xu, Xu, Uu, Xu, Xu, Xu, Xu
Xu, Xu, Xu, Xu, Xu, Xu, Ww, Ww, Ww, Uu, Uu, Xu, Xu, Xu, Xu, Xu, Xu, Xu, Wwg, Xu, Wwg, Ur, Ur, Xu, Xu, Xu, Xu, Xu, Xu, Xu, Xu, Xu, Ur, Xu, Xu, Xu, Uu, Uu, Xu, Xu, Xu, Xu
Xu, Xu, Xu, Xu, Uu, Uu, Ww, Ww, Xu, Xu, Xu, Uu, Uu, Xu, Xu, Xu, Xu, Xu, Wwg, Wwg, Xu, Wwg, Wwg, Wwg, Wwg, Xu, Wwg, Xu, Xu, Xu, Xu, Xu, Ur, Xu, Xu, Xu, Uu, Xu, Xu, Xu, Xu, Xu
Xu, Xu, Uu, Uu, Xu, Xu, Ww, Ww, Uu, Xu, Xu, Xu, Uu, Xu, Xu, Xu, Xu, Xu, Wwg, Xu, Xu, Xu, Ur, Uu, Wwg, Wwg, Wwg, Xu, Xu, Xu, Xu, Xu, Ur, Uu, Uu, Xu, Uu, Xu, Xu, Xu, Xu, Xu
Uu, Uu, Xu, Xu, Xu, Xu, Ww, Uu, Uu, Xu, Xu, Xu, Xu, Uu, Xu, Xu, Xu, Xu, Wwg, Xu, Uu, Uu, Ur, Xu, Xu, Xu, Wwg, Xu, Xu, Xu, Xu, Xu, Ur, Ur, Xu, Uu, Uu, Uu, Uu, Xu, Xu, Xu
Uu, Xu, Xu, Xu, Ww, Ww, Xu, Xu, Uu, Xu, Xu, Xu, Xu, Uu, Xu, Xu, Xu, Xu, Wwg, Wwg, Xu, Xu, Ur, Xu, Uu, Uu, Wwg, Uu, Xu, Xu, Xu, Xu, Uu, Ur, Xu, Xu, Xu, Xu, Xu, Uu, Uu, Xu
Xu, Xu, Ww, Ww, Xu, Xu, Xu, Xu, Uu, Uu, Xu, Xu, Xu, Uu, Xu, Xu, Xu, Xu, Uu, Wwg, Xu, Xu, Ur, Uu, Xu, Xu, Wwg, Uu, Xu, Xu, Xu, Xu, Uu, Ur, Xu, Xu, Xu, Xu, Xu, Xu, Uu, Xu
Uu, Ww, Xu, Xu, Xu, Xu, Xu, Xu, Uu, Uu, Xu, Xu, Xu, Uu, Xu, Xu, Xu, Xu, Uu, Wwg, Uu, Uu, Uu, Uu, Uu, Uu, Wwg, Xu, Xu, Xu, Xu, Xu, Uu, Ur, Xu, Xu, Xu, Xu, Xu, Xu, Uu, Xu
