Xu, Xu, Uu, Xu, Xu, Xu, Xu, Uu, Xu, Xu, Xu, Xu, Ww, Uu, Xu, Xu, Xu, Xu, Uu, Xu, Xu, Xu, Xu, Xu, Xu, Xu, Uu, Xu, Xu, Xu, Ww, Xu, Xu, Xu, Ww, Xu, Xu, Xu, Xu, Uu, Xu, Uu
Xu, Xu, Uu, Xu, Xu, Xu, Xu, Uu, Xu, Xu, Xu, Xu, Xu, Ww, Ww, Xu, Xu, Xu, Xu, Uu, Xu, Xu, Xu, Xu, Xu, Uu, Uu, Xu, Ww, Xu, Ww, Xu, Xu, Xu, Ww, Xu, Xu, Xu, Uu, Uu, Xu, Xu
Xu, Xu, Uu, Xu, Xu, Xu, Xu, Uu, Xu, Xu, Xu, Xu, Xu, Xu, Xu, Ww, Uu, Uu, Uu, Uu, Xu, Xu, Xu, Xu, Xu, Uu, Ww, Ww, Ww, Ww, Xu, Xu, Xu, Xu, Ww, Xu, Xu, Xu, Uu, Xu, Xu, Xu
Xu, Xu, Xu, Uu, Uu, Xu, Uu, Uu, Xu, Xu, Xu, Xu, Xu, Xu, Xu, Ww, Xu, Uu, Xu, Uu, Xu, Xu, Xu, Xu, Xos, Ww, Xu, Ww, Xu, Xu, Xu, Xu, Xu, Xu, Ww, Xu, Xu, Xu, Uu, Xu, Uu, Uu
Xu, Xu, Xu, Xu, Xu, Uu, Xu, Uu, Uu, Xu, Xu, Xu, Xu, Xu, Xu, Ww, Ww, Xos, Xor, Uu, Xor, Xu, Xor, Xor, Xor, Ww, Xor, Xu, Xor, Xu, Xor, Xu, Xor, Ww, Uu, Xu, Xu, Uu, Xu, Xu, Uu, Xu
Xu, Xu, Xu, Xu, Xu, Uu, Xu, Xu, Xu, Uu, Uu, Xu, Uu, Xor, Xor, Xor, Ww, Xor, Uu, Uu, Uh, Xor, Uu, Uu^Vud, Ww, Ww, Uu, Xor, Uu, Xor, Uu, Xor, Ww, Ww, Uu, Uu, Uu, Uu, Uu, Uu, Xu, Xu
Xu, Xu, Xu, Xu, Xu, Uu, Xu, Xu, Xor, Xu, Xu, Uu, Uu, Uh, Uh, Uh, Uh, Ww, Uh, Uh, Ww, Uh, Uh, Ww, Ww, Uu, Uu, Uu, Ww, Uu, Ww, Ww, Ww, Uh, Xor, Xu, Xu, Xu, Xu, Uu, Uu, Uu
Xu, Xu, Xu, Xu, Xu, Uu, Uu, Uu, Uu, Xor, Xor, Xor, Uh, Uh, Uu^Vud, Uu, Uh, Ww, Ww, Ww, Ww, Ww, Ww, Ww, Ww, Ww, Ww, Ww, Uh, Ww, Uh, Ww, Uh, Uu, Uu, Xor, Xu, Xu, Xu, Xu, Xu, Xu
Xu, Xu, Xu, Xu, Xu, Uu, Xu, Xu, Xu, Uu, Uh, Uh, Uu, Uh, Uh, Uh, Uh, Uu, Ww, Ww, Ww, Ww, Ww, Ww, Ww, Ww, Ww, Uu, Uh, Uh, Uh, Uu^Vud, Uh, Uh, Uu, Xor, Xu, Xu, Xu, Xu, Xu, Xu
Xu, Xu, Xu, Xu, Xu, Xu, Xu, Xu, Xu, Xor, Uu, Uh, Uu, Uh, Uh, Uh, Uu, Uu, Ww, Ww, Ww, Ww, Ww, Ww, Ww, Ww, Ww, Uu^Vud, Rb, Uh, Rb, Uh, Uh, Uh, Uu, Xor, Xu, Xu, Xu, Xu, Xu, Xu
Xu, Xu, Xu, Xu, Xu, Xu, Xu, Xu, Xu, Xor, Uu, Uu, Uu, Uu, Uh, Uh, Uu, Uh, Ww, Ww, Ww, Uh, Uu, Uh, Uh, Ww, Ww, Ww, Ww, Rb, Rb, Uh, Uu, Uu, Uu, Xor, Xor, Xu, Xu, Xu, Xu, Xu
Xu, Xu, Xu, Xu, Xu, Xu, Xu, Xu, Xor, Xor, Uu, Uu, Uu^Vud, Uh, Uu, Uh, Uh, Uu^Vud, Ww, Ww, Uu, Uu^Ecf, Ce, Uu, Uu, Uh, Uh, Uu, Uh, Uu, Uh, Uu, Uu, Uu, Uu, Xor, Xor, Xu, Xu, Xu, Xu, Xu
Uu, Xu, Uu, Xu, Uu, Uu, Uu, Uu, Uu, Uu, Uu, Uu, Uu, Uh, Uu, Uu, Uu, Uh, Ww, Uu, Ce, Ce, 1 Ke, Ce, Rb, Rb, Rb, Rb, Rb, Rb, Rb^Emf, Uu, Uu, Uu, Uu, Uu, Uu, Xu, Xu, Xu, Uu, Uu
Uu, Uu, Xu, Uu, Xu, Xu, Xu, Xu, Xu, Xor, Uu, Uu, Uu, Uh, Uu, Uu, Uu, Uu, Ww, Uu, Uu, Ce, Ce, Ce, Uh, Rb, Uh, Uu, Uu, Uu, Uu, Uu, Uu, Uu, Uu, Xor, Xor, Uu, Xu, Uu, Uu, Xu
Uu, Uu, Uu, Xu, Xu, Xu, Xu, Xu, Xu, Xor, Uu, Uu, Uu, Uh, Uu, Uu, Ww, Ww, Uu, Uu, Uu, Uu, Uu, Uu, Uh, Uh, Uu, Uu^Vud, Uu, Uh, Uh, Uh, Uh, Uu, Uu, Xor, Xom, Uu, Uu, Uu, Xu, Xu
Xu, Xu, Xu, Uu, Uu, Xu, Uu, Xu, Xu, Xor, Uu, Uu, Uu, Uu, Uu^Emf, Uu, Ww, Uu^Vud, Uh, Uh, Uh, Uu, Uu, Uh, Uu, Uh, Rb, Rb^Emf, Uh, Uh, Uu, Uu^Vud, Uu, Uu, Uh, Xor, Xu, Xu, Xu, Uu, Xu, Xu
Xu, Xu, Xu, Xu, Xu, Uu, Xu, Uu, Uu, Xor, Uu, Uu, Uu, Uu^Vud, Uu, Uh, Ww, Uh, Uh, Uu, Uu, Uh, Uu, Uh, Uu, Uu, Uh, Uu, Uh, Uu, Uu, Uu, Uu, Uu, Uu, Xor, Xu, Xu, Xu, Xu, Xu, Xu
Xu, Xu, Xu, Xu, Xu, Xu, Xu, Xu, Xu, Uu, Uu, Uu, Uh, Uh, Uh, Ww, Uh, Uh, Uu, Uu, Uu, Uh, Uu^Vud, Uh, Rb, Rb, Uh, Uu, Uh, Uh, Uu, Uu, Uu, Uu, Uu, Xor, Xu, Xu, Xu, Xu, Xu, Xu
Xu, Xu, Xu, Xu, Xu, Xu, Xu, Xu, Xu, Xor, Uu, Uu, Uh, Uu, Uh, Ww, Uh, Uu^Vud, Uh, Uu, Uh, Uh, Uu, Rb^Emf, Uh, Uu, Uh, Uh, Uh, Uh, Uu, Uh, Uu, Uh, Uh, Xor, Xor, Xu, Xu, Xu, Xu, Xu
Xu, Xu, Xu, Xu, Xu, Xu, Xu, Xu, Xu, Xor, Uu, Uh, Uu, Uu, Ww, Ww, Uh, Uu, Uh, Uu, Uu^Emf, Uu, Uu, Uu, Uh, Uh, Uh, Uu, Uu, Uh, Uu^Vud, Uu, Uh, Uu, Uu, Xor, Xor, Xu, Xu, Xu, Xu, Xu
Xu, Xu, Xu, Xu, Xu, Xu, Xu, Xu, Xu, Xor, Uu, Uh, Ww, Ww, Uh, Uh, Uu, Uu, Xor, Xor, Uu, Xor, Xor, Uu, Uu^Vud, Uu, Uh, Uu, Uh, Uu, Uh, Uh, Uh, Uh, Uu, Uu, Uu, Xu, Xu, Xu, Xu, Xu
Xu, Xu, Uu, Xu, Xu, Xu, Xu, Xu, Xu, Xor, Xor, Uh, Ww, Ww, Uh, Uu, Xor, Xor, Xom, Xor, Uu, Xu, Xu, Xor, Xor, Uu, Uu, Uh, Uu, Uu, Uu, Uu, Uh, Uh, Xor, Xor, Xor, Uu, Uu, Xu, Uu, Xu
Uu, Uu, Xu, Uu, Uu, Uu, Uu, Xu, Xu, Xor, Ww, Ww, Xor, Uh, Xor, Xor, Xu, Xu, Xu, Xu, Uu, Xu, Xu, Xu, Xu, Xor, Xor, Uh, Uu, Uu, Uu, Uh, Xor, Xor, Xu, Xu, Xu, Xu, Uu, Uu, Xu, Uu
Xu, Xu, Xu, Xu, Xu, Xu, Xu, Uu, Uu, Ww, Xu, Xu, Xu, Xor, Xu, Xu, Xu, Xu, Xu, Xu, Uu, Xu, Xu, Xu, Xu, Xu, Xu, Xor, Xor, Uu, Uu, Xor, Xor, Xu, Xu, Xu, Xu, Uu, Xu, Xu, Xu, Xu
Xu, Xu, Xu, Xu, Xu, Xu, Uu, Uu, Ww, Ww, Uu, Xu, Xu, Xu, Xu, Xu, Xu, Xu, Xu, Xu, Uu, Xu, Xu, Xu, Xu, Xu, Xu, Xu, Xu, Xor, Xor, Uu, Uu, Xu, Xu, Xu, Xu, Uu, Xu, Xu, Xu, Xu
Xu, Xu, Xu, Xu, Xu, Xu, Ww, Ww, Ww, Uu, Uu, Xu, Xu, Xu, Xu, Xu, Xu, Xu, Xu, Xu, Uu, Xu, Uu, Xu, Xu, Xu, Xu, Xu, Xu, Xu, Xu, Xu, Uu, Xu, Xu, Xu, Uu, Uu, Xu, Xu, Xu, Xu
Xu, Xu, Xu, Xu, Uu, Uu, Ww, Ww, Xu, Xu, Xu, Uu, Uu, Xu, Xu, Xu, Xu, Xu, Uu, Uu, Xu, Uu, Uu, Uu, Uu, Xu, Xu, Xu, Xu, Xu, Xu, Xu, Uu, Xu, Xu, Xu, Uu, Xu, Xu, Xu, Xu, Xu
Xu, Xu, Uu, Uu, Xu, Xu, Ww, Ww, Uu, Xu, Xu, Xu, Uu, Xu, Xu, Xu, Xu, Xu, Uu, Xu, Xu, Xu, Uu, Uu, Xu, Uu, Uu, Xu, Xu, Xu, Xu, Xu, Uu, Uu, Uu, Xu, Uu, Xu, Xu, Xu, Xu, Xu
Uu, Uu, Xu, Xu, Xu, Xu, Ww, Uu, Uu, Xu, Xu, Xu, Xu, Uu, Xu, Xu, Xu, Xu, Uu, Xu, Uu, Uu, Uu, Xu, Xu, Xu, Uu, Xu, Xu, Xu, Xu, Xu, Uu, Xu, Xu, Uu, Uu, Uu, Uu, Xu, Xu, Xu
Uu, Xu, Xu, Xu, Ww, Ww, Xu, Xu, Uu, Xu, Xu, Xu, Xu, Uu, Xu, Xu, Xu, Xu, Uu, Uu, Xu, Xu, Uu, Xu, Uu, Uu, Uu, Uu, Xu, Xu, Xu, Xu, Uu, Xu, Xu, Xu, Xu, Xu, Xu, Uu, Uu, Xu
Xu, Xu, Ww, Ww, Xu, Xu, Xu, Xu, Uu, Uu, Xu, Xu, Xu, Uu, Xu, Xu, Xu, Xu, Uu, Xu, Xu, Xu, Uu, Uu, Xu, Xu, Uu, Uu, Xu, Xu, Xu, Xu, Uu, Xu, Xu, Xu, Xu, Xu, Xu, Xu, Uu, Xu
Uu, Ww, Xu, Xu, Xu, Xu, Xu, Xu, Uu, Uu, Xu, Xu, Xu, Uu, Xu, Xu, Xu, Xu, Uu, Uu, Uu, Uu, Uu, Uu, Uu, Uu, Uu, Xu, Xu, Xu, Xu, Xu, Uu, Xu, Xu, Xu, Xu, Xu, Xu, Xu, Uu, Xu
