Ms, Ms, Ms, Ms, Ms, Ms, Ms, Ms, Ms, Ms, Ha, Ha, Ha, Ms, Ms, Ms, Aa^Fpa, Gg, Ms, Ms^Xm, Ms^Xm, Ms^Xm
Ms, Ms, Ms, Ms, Ms, Ms, Ms, Ms, Ms, Ms, Ha^Vhha, Ha, Ha, Ms, Ms, Ms, Aa^Fpa, Aa^Vea, Ms, Ms^Xm, Ms^Xm, Ms^Xm
Ms, Ms, Ms, Ms, Ms, Ms, Aa^Feta, Ha, Ms, Ms, Ms, Aa^Fpa, Aa^Fpa, Ha, Ha, Aa^Fpa, Aa^Fpa, Ms, Ms, Ms, Ms^Xm, Ms^Xm
Ms, Ms, Ms, 3 Kva, Cva, Aa^Fpa, Aa^Fpa, Ha, Aa^Fpa, Ms, Aa, Aa^Fpa, Aa, Aa, Aa, Ha, Cha, Cha, Ms, Ms, Ms, Ms^Xm
Ms, Ms, Ms, Cva, Gd, Gd, Gd, Aa^Fpa, Gd, Aa^Fpa, Gd, Gd, Gd, Gd, Aa, Aa, Rp, Rp, Rp, Cha, Ms, Ms
Cha, Cha, Gd, Gd, Aa, Gd, Aa, Gd, Gd, Aa, Rp, Aa, Rp, Rp, Rp, Rp, Aa, Rp, Aa, Cha, Hh, Hh
Hh, Ha^Vhha, Gd, Gd, Gd, Gd, Gd, Gd, Rp, Rp, Aa, Rp, Aa, Aa^Esa, Aa, Aa, Rp, Rp, Gs^Fp, Hh, Gg^Fet, Gs^Fp
Gs^Fp, Gs^Fp, Gs^Fp, Gs, Gs^Fp, Gd, Gd, Rp, Aa, Aa, Chr, Aa, Aa, Aa, Aa, Rp, Aa, Aa, Gll^Fp, Gll^Fp, Hh, Hh
Ha, Ha, Ha, Hh^Fp, Hh^Fp, Gd, Rp, Rp, Aa, Chr, Gs^Fp, Gll^Fp, Gll^Fp, Aa, Rp, Rp, Aa, Gs^Fp, Hh, Hh, Hh^Vhhr, Hh
Ms, Ms, Ms, Ms, Ms, Gs^Fp, Rp, Aa, Gd, Gs^Vc, Gd, Gs^Fp, Gll^Fp, Gll^Fp, Rp, Aa, Aa, Hh, Ms, Ms, Ms, Ms
Ms, Ms, Ms, Ms, Ms, Ms, Rp, Gs, Gd, Gd, Hh^Fp, Gll^Fp, Gll^Fp, Gll^Fp, Rp, Aa, Aa, Hh, Ms, Ms, Ms, Ms
Ms, Ms, Ms, Ms, Ha, Ha, Rp, Gd, Hh, Hh, Ms, Hh^Fp, Hh^Fp, Gll^Fp, Rp, Aa, Ms, Ms, Ms, Ms, Ms, Ms
Ms, Ms, Ms, Ha, Ha, Aa^Feta, Rp, Hh, Ms, Ms, Ms, Ms, Ms, Hh, Aa, Rp, Hh, Ms, Gll^Fp, Gs^Fp, Aa^Vha, Ha
Ms, Ms, Ha, Aa^Vea, Gd, Rp, Gg^Efm, Hh, Ms, Ms, Ms, Ms, Ms, Ms, Aa, Rp, Aa^Esa, Hh, Gs^Fp, Ha, Ha, Ha
Ms, Ha, Ha, Ha, Gd, Rp, Hh, Ms, Ms, Ms, Ms, Ms, Ms, Hh^Fp, Aa, Rp, Aa, Aa, Gs^Fp, Ha, Ha, Ha
Ha, Ha, Gll^Fp, Gd, Rp, Rp, Gd, Hh, Cha, Ms, Ms, Ms, Ha^Vhha, Hh^Fp, Aa^Esa, Rp, Aa, Aa, Gd, Ha, Cha, Cha
Ha, Ha, Gll^Fp, Gs^Fp, Rp, Aa, Gd, Gd, Cha, Cha, Ms, Ms, Hh^Fpa, Aa, Rp, Rp, Gs^Fp, Aa, Aa, Gd, Gd, Gd
Hh^Fp, Hh^Fp, Gll^Fp, Gs^Fp, Rp, Aa, Aa^Esa, Aa, Hh, Hh, Ms, Aa^Feta, Gd, Rp, Gd, Gd, Gs^Fp, Gs^Fp, Aa^Vha, Gd, Gd, Gd
Ha, Ha, Ms, Ha, Cha, Rp, Rp, Aa, Aa, Hh, Gd, Gd, Rp, Rp, Gd, Gd, Gd, Gs^Fp, Ha, Ha, Ha, Ha
Ms, Ms, Ms, Ha, Ha, Gd, Rp, Gd, Rp, Rp, Rp, Rp, Gd, Gd, Gd, Gd, Ms, Ms, Ms, Ha, Ha, Ha
Ms, Ms, Ms, Ha, Gs^Vct, Rp, Gd, Re^Es, Gs, Gd, Cha, Gd, Gd, Gd, Gd, Gs^Fp, Gs^Fp, Ms, Ms, Ha, Ms, Ms
Chr, Chr, Ms, Hh^Fp, Gs, Rp, Gd, Gs, Gd, Ha, Ms, Ha, Gs^Fp, Gd, Gd, Gd, Gs^Fp, Ms, Ms, Ms, Ms, Ms
Chr, Chr, Chr, Hh^Fp, Ce, Ce, Ce, Gs, Gs^Vct, Ha, Ms, Ha, Ha, Gs^Fp, Gll^Fp, Gll^Fp, Gll^Fp, Ha, Ms, Ms, Ms, Ms
Xu, Xu, Xu, Re, Ce, 1 Ke, Ce, Gd, Ha, Ms, Ms, Ms, Ms, Ha, Gs^Fp, Gs^Fp, Gs^Fp, Ha, Ha^Vhha, Ms, Mm^Xm, Mm^Xm
Uh, Uh^Ii, Re^Ii, Re^Ii, Re^Es, Ce, Ms, Ha, Ms, Ms, Ms, Ms, Mm^Xm, Mm^Xm, Ms, Gg^Fet, Gg^Fet, Ha, Ms, Ms, Mm^Xm, Mm^Xm
Re, Re^Ii, Uu^Ii, Uu, Xu, Ms, Chr, Ms, Chr, Ha^Vhha, Ms, Ms, Ms, Ms, Mm^Xm, Ms, Ms, Ms, Mm^Xm, Mm^Xm, Mm^Xm, Mm^Xm
Re, Uu, Uh, Xu, Xu, Xu, Chr, Chr, Chr, Ha, Ms, Ms, Ms, Ms, Mm^Xm, Ms, Ms, Ms, Mm^Xm, Mm^Xm, Mm^Xm, Mm^Xm
