Xu, Xu, Xu, Uue, Xu, Uue, Xu, Uue, Xu, Uue, Xu, Xu, Xu, Xu, Xu, Xu, Xu, Xu, Xu, Xu, Xu, Xu, Xu, Wwt, Wwt, Xu, Xu, Uue, Xu, Uue, Xu, Uue, Xu, Uue, Uue, Uue, Uue, Uue, Uue, Uue, Uue, Uue, Uue, Uue, Uue, Uue
Xu, Xu, Xu, Xu, Xu, Xu, Xu, Xu, Xu, Xu, Xu, Xu, Xu, Xu, Xu, Xu, Xu, Xu, Xu, Xu, Xu, Xu, Xu, Wwt, Xu, Xu, Xu, Xu, Xu, Xu, Xu, Xu, Xu, Xu, Uue, Uue, Uue, Uue, Uue, Uue^Br|, Uue, Uue, Uue, Uue, Uue, Uue
Uue, Xu, Xu, Xu, Xu, Xu, Xu, Xu, Xu, Xu, Xu, Xu, Xu, Xu, Xu, Xu, Xu, Xu, Xu, Xu, Xu, Xu, Xu, Wwt, Xu, Xu, Xu, Xu, Xu, Xu, Xu, Xu, Xu, Xu, Uue, Uue, Uu^Vud, Uue, Uue, Uue^Br|, Uue, Uue, Uue, Uue, Uue, Uue
Uue, Uue, Uue, Xu, Uue, Xu, Uue, Xu, Uue, Xu, Uue, Uue, Uue, Uue, Uue, Xu, Xu, Xu, Xu, Xu, Xu, Xu, Wwt, Wwt, Xu, Xu, Xu, Xu, Xu, Xu, Xu, Xu, Xu, Xu, Uue, Uue, Uue, Uue, Uue, Uue^Br|, Re^Vct, Uue, Uue, Uue, Uue, Uue
Uue, Uue, Uue, Uue, Uue, Uue, Uue, Uue, Uue, Uue, Uue, Uue, Uue, Uue, Uue, Uue, Uue, Uue, Uue, Xu, Uue, Xu, Wwt, Uue, Uue, Uue, Uue, Xu, Xu, Xu, Xu, Xu, Xu, Xu, Uue, Uue, Uue, Uue, Ket, Cud, Cud, Uue, Uue, Uue, Uue, Uue
Uue, Uue, Uue, Uue, Uue, Uue, Uue, Uue, Uue, Uu^Vud, Uue, Uue, Uue, Uue, Uue, Uue, Uue, Uue, Uue, Uue, Uue, Uue, Wwt, Uue, Uue, Uue, Uue, Uue, Uue, Uue, Uue, Uue, Uue, Uue, Uu^Vud, Uue, Uue, 1 Ke, Ket, 3 Kud, Cud, Uue, Uue, Uue, Uue, Uue
Uue, Uue, Xur, Uue, Uue, Uue, Uue, Uue, Uue, Uue, Uue, Uue, Uue, Uue, Uue, Uue, Uue, Uue, Uue, Uue, Uue, Uue, Wwt, Uue, Uu, Uue, Uue, Uue, Uue, Uue, Uue, Uue, Uue, Uue, Uue, Uue, Uue^Br/, Ket, Re^Vct, Cud, Uue, Uue, Uue, Uue, Uue, Uue
Xur, Xur, Xur, Xur, Xur, Uue, Uue, Uue, Uue, Uue, Uue, Uhe, Uhe, Uhe, Uhe, Uue, Uhe, Uu^Vu, Uue, Uue, Uue, Uue, Wwt, Uu, Uu, Uu, Uu, Uue, Uue, Uue, Uu, Uue, Uue, Uue, Uue^Br/, Uue^Br/, Uue, Uu, Uue, Uue, Uue, Uue, Uue, Uu^Vud, Uue, Uue
Xur, Xur, Xur, Xur, Xur, Xur, Xur, Uue, Uue, Uue, Uue, Uue, Uue, Uhe, Uhe, Uhe, Uhe, Uhe, Uhe, Uue, Uue, Wwt, Uue, Uu, Uu, Uu, Uu, Uu, Uu, Uu, Uu, Uu, Uu^Br/, Uue^Br/, Uue, Uue, Uu, Uu, Uue, Uu^Vu, Uue, Uue, Uue, Uue, Uue, Uue
Uue, Xur, Uue, Xur, Xur, Xur, Xur, Xur, Xur, Xur, Xur, Uue, Uue, Uue, Uue, Uue, Tb^Tf, Uhe, Uhe, Uue, Sm, Wwt, Uue, Uue, Uue, Uu, Uu, Uu, Uu, Uu, Uu^Br/, Uu^Br/, Uu, Uu, Uu, Uue, Uu, Uue, Uue, Uue, Uue, Uue, Uue, Uue, Uue, Uue
Uue, Uue, Uue, Uue, Xur, Xur, Xur, Xur, Xur, Xur, Xur, Xur, Xur, Uue, Uue, Uue, Uue, Uue, Sm, Sm, Uue, Wwt, Uue, Uue, Uue, Uue, Uu, Uu, Uu^Br/, Uu^Br/, Xu, Uu, Uu, Uu, Uu, Uu, Uue, Uue, Uue, Uue, Uue, Uue, Uue, Uue, Uue, Uue
Uue, Uue, Uue, Uue, Uue, Xur, Uue, Xur, Xur, Xur, Xur, Xur, Xur, Xur, Xur, Uue, Uue, Uue, Sm, Uue, Wwt, Wwt, Uue, Uue, Uue, Uue, Ur, Ur, Xu, Xu, Xu, Xu, Xu, Uu, Uu, Uu, Uu, Uue, Uue, Uue, Uue, Uue, Uue, Uue, Uue, Uue
Uue, Uue, Uue, Uue, Uue, Uue, Uue, Uue, Uue, Uue, Uue, Xur, Xur, Xur, Xur, Uue, Wwt, Wwt, Xu, Xu, Wwt, Uue, Uue, Uhe, Ur, Ur, Xu, Xu, Xu, Xu, Xu, Xu, Xu, Uu, Uu, Uu, Uu, Uue, Uu^Vu, Uue, Uue, Uue, Uue, Uue, Uue, Uue
Uue, Uue, Uue, Uue, Uue, Uue, Uue, Uue, Uue, Uue, Uue, Uue, Uue, Xur, Xu, Xu, Wwt, Xu, Xu, Xu, Wwt, Uue, Ur, Ur, Uhe, Uue, Uue, Xu, Xu, Xu, Xu, Xu, Xu, Xu, Uu, Uu, Uu, Uu, Uu, Uu, Uu, Uu, Uu, Uu, Uu, Uue
Uue, Uue, Uue, Uue, Uue, Uue, Uue, Uhe, Uue, Uue, Uue, Uue, Uue, Uue, Wwt, Wwt, Xu, Xu, Xu, Xu, Wwt, Uue, Ur, Uhe, Uue, Uue, Uue, Uue, Xu, Xu, Xu, Xu, Xu, Xu, Uue, Uu, Uu, Uu, Uu, Uu, Uu, Uu, Uu, Uu, Uu, Uu
Uue, Uue, Uue, Uue, Uue, Uu^Vu, Uue, Uue, Uue, Uue, Uue, Uue, Uue, Uue, Wwt, Xu, Xu, Xu, Xu, Xu, Wwt, Ur, Uue, Uue, Uue, Uue, Uue, Uue, Xu, Xu, Xu, Xu, Uue, Uue, Uue, Uue, Uue, Uu, Uu, Uu, Uu, Uu, Uu, Uu, Uu, Uu
Uue, Uue, Uue, Uue, Uhe, Uhe, Uhe, Uhe, Uue, Uhe, Uue, Uue, Uue, Wwt, Uue, Xu, Xu, Xu, Xu, Xu, Wwt, Ur, Xu, Xu, Xu, Uue, Uue, Uue, Uue, Xu, Xu, Xu, Uue, Uue, Uue, Uue, Uue, Uue, Uue, Uue, Uue, Uue, Uue, Uue, Uue, Uue
Uue, Uue, Uue, Uhe, Uhe, Uhe, Uhe, Uhe, Cte, Cte, Ur, Uu^Vu, Ur, Wwt, Wwt, Uue, Ur, Xu, Tb^Tf, Uue, Wwt, Wwt, Xu, Xu, Xu, Uue, Uue, Uue, Uue, Xu, Xu, Xu, Uue, Uue, Uue, Uue, Uue, Uue, Uue, Uue, Uue, Uue, Uue, Uue, Uue, Uue
Uue, Uue, Uue, Uhe, Uhe, Uhe, Uue, Uhe, Cte, 2 Kte, Ur, Ur, Wwt, Wwt, Wwt, Ur, Xu, Ur, Ur, Ur, Uu^Vud, Wwt, Wwt, Xu, Uue, Uue, Uue, Uue, Uue, Uue, Uue, Uue, Uue, Uue, Uue, Uue, Uue, Uue, Uue, Uue, Uue, Uue, Uue, Uue, Uue, Uue
Uue, Uue, Uue, Uhe, Uu^Vu, Uue, Uhe, Uhe, Uhe, Uhe, Uue, Uue, Wwt, Wwt, Wwt, Xu, Xu, Xu, Uu^Vud, Uu^Vud, Ur, Ur, Wwt, Uue, Uue, Uue, Uue, Uhe, Uhe, Uue, Uue, Uue, Uue, Uue, Uue, Uhe, Uhe, Uue, Uue, Uue, Uue, Uue, Uue, Uue, Uue, Uue
Uue, Uue, Uue, Uue, Uue, Uue, Uue, Uue, Uue, Uue, Uue, Wwt, Wwt, Wwt, Wwt, Xu, Xu, Xu, Ur, Ur, Xu, Wwt, Uue, Ur, Ur, Ur, Ur, Uhe, Uue, Uue, Uue, Uue, Uue, Uue, Uue, Uhe, Uhe, Uue, Uue, Uue, Uue, Uue, Uue, Uue, Uue, Uue
Uue, Uue, Uue, Uue, Uue, Uue, Uue, Uue, Uue, Uue, Xu, Wwt, Wwt, Wwt, Wwt, Wwt, Uue, Uue, Ur, Ur, Wwt, Wwt, Xu, Uue, Uue, Uue, Uue, Ur, Ur, Ur, Uue, Uue, Uue, Uue, Uue, Uue, Uue, Uue, Uue, Uue, Uue, Uue, Uue, Uue, Uue, Uue
Uue, Uue, Uue, Uue, Uue, Uue, Uue, Uue, Uue, Xu, Xu, Xu, Xu, Wwt, Wwt, Wwt, Uue, Uue, Ur, Wwt, Xu, Xu, Xu, Tb^Tf, Uue, Uue, Xu, Xu, Xu, Ur, Ur, Uue, Uue, Uue, Uue, Uue, Uue, Uue, Uue, Uue, Uue, Uue, Uue, Uue, Uue, Uue
Uue, Uue, Uue, Uue, Uue, Uue, Uue, Uue, Uue, Xu, Xu, Xu, Xu, Wwt, Wwt, Wwt, Uue, Uue, Wwt, Wwt, Xu, Xu, Xu, Xu, Xu, Xu, Xu, Xu, Xu, Uue, Ur, Uue, Uue, Uue, Uue, Uue, Uue, Uue, Uue, Uue, Uue, Uue, Uue, Uue, Uue, Uue
Uue, Uue, Uue, Uue, Uue, Uue, Uue, Uue, Uue, Xu, Xu, Xu, Xu, Uue, Uue, Uue, Wwt, Wwt, Ur, Ur, Uue, Xu, Xu, Xu, Xu, Xu, Xu, Xu, Uue, Uue, Uue, Ur, Ur, Uue, Uue, Uue, Uue, Uue, Uue, Uue, Uue, Uue, Uue, Uue, Uue, Uue
Uue, Uue, Uue, Uue, Uue, Uue, Uue, Uue, Uue, Xu, Xu, Xu, Xu, Xu, Uue, Uue, Wwt, Wwt, Uue, Ur, Ur, Uue, Uue, Xu, Uue, Uue, Uue, Uue, Uue, Uue, Uue, Uue, Uue, Ur, Ur, Uue, Uue, Uue, Uue, Uue, Uue, Uue, Uue, Uue, Uue, Uue
Uue, Uue, Uue, Uue, Uue, Uue, Xu, Uue, Xu, Xu, Xu, Xu, Xu, Xu, Uue, Wwt, Uue, Uue, Uue, Ur, Ur, Uue, Uue, Uue, Uue, Uue, Xu, Uue, Xu, Uue, Xu, Xu, Xu, Uue, Ur, Uu^Vu, Uue^Emf, Uue, Uue, Uue, Uue, Uue, Uue, Uue, Uue, Uue
Uue, Uue, Uue, Uue, Xu, Xu, Xu, Xu, Xu, Xu, Xu, Xu, Wwt, Wwt, Wwt, Wwt, Xu, Uue, Uue, Uue, Ur, Uue, Uue, Uue, Xu, Xu, Xu, Xu, Xu, Xu, Xu, Xu, Xu, Uue, Uue, Ur, Ur, Uue, Uue, Uue, Uue, Uue, Uue, Uue, Uue, Uue
Xu, Xu, Xu, Xu, Xu, Xu, Xu, Xu, Xu, Xu, Wwt, Xu, Wwt, Wwt, Xu, Xu, Xu, Xu, Xu, Uue, Uu^Vud, Ur, Uue, Uue, Xu, Xu, Xu, Xu, Xu, Xu, Xu, Xu, Uue, Uue, Uue, Uue, Ur, Uue, Uue, Uue, Uue, Uue, Uue, Uue, Uue, Uue
Xu, Xu, Xu, Xu, Xu, Xu, Uue, Xu, Wwt, Wwt, Tb^Emf, Wwt, Uue, Uue, Uue, Xu, Xu, Xu, Xu, Xu, Uue, Ur, Uue, Xu, Xu, Xu, Xu, Xu, Uue, Xu, Uue, Uue, Uue, Uue, Uue, Uue, Uue, Ur, Ur, Uue, Uue, Uue, Uue, Uue, Uue, Uue
Uue, Xu, Xu, Xu, Uue, Uue, Uue, Wwt, Uue, Tb^Emf, Ur, Uue^Emf, Uu^Vud, Ur, Ur, Uue, Ur, Xu, Xu, Xu, Uue, Ur, Uue, Xu, Xu, Xu, Uue, Uue, Uue, Uue, Uue, Uue, Uue, Uue, Uue, Uue, Uue, Uue, Ur, Ur, Ur, Uue, Uue, Uue, Uue, Uue
Uue, Uue, Uue, Uue, Uue, Uue, Uue, Wwt, Uue, Uue, Uue, Ur, Uue, Uue, Uue, Ur, Uue, Ur, Ur, Uue, Uue, Ur, Uue, Xu, Xu, Xu, Uue, Uue, Uue, Uue, Uue, Uue, Uue, Uue, Uue, Uue, Uue, Uue, Uue, Ur, Ur, Uu^Vud, Uue, Uue, Uue, Uue
Uue, Uue, Uue, Uue, Uue, Uue, Uue, Wwt, Uue, Uue, Uue, Uue, Uue, Uue, Uue, Uue, Uue, Uue, Uue, Ur, Ur, Ur, Uue, Uue, Uue, Uue, Uue, Uue, Uue, Uue, Uue, Uue, Uue, Uue, Uue, Uue, Uue, Uue, Uue, Uue, Ur, Uue^Emf, Uue, Uue, Uue, Uue
Uue, Uue, Uue, Uue, Uue, Uue, Uue, Wwt, Uue, Uue, Uue, Uue, Uue, Uue, Uue, Uue, Uue, Uue, Ur, Ur, Uue, Uue, Uue, Uue, Uue, Uue, Uue, Uue, Uue, Uue, Uue, Uue, Uue, Uue, Uue, Uue, Uue, Uue, Uue, Uue, Uue, Ur, Ur, Uue, Uue, Uue
Uue, Uue, Uue, Uue, Uue, Uue, Uue, Wwt, Uue, Uue, Uue, Uue, Uue, Uue, Uue, Uue, Uue, Uue, Ur, Uue, Uue, Uue, Uue, Uue, Uue, Uue, Uue, Uue, Uue, Uue, Uue, Uue, Uue, Uue, Uue, Uue, Uue, Uue, Uue, Uue, Uue, Uue, Ur, Uue, Uue, Uue
