Uu, Ur, Re, Xu, Xu, Qxu, Qxu, Xu, Xu, Xu, Qxu, Qxu, Xu, Xu, Xu, Xu, Xu, Xu, Xu, Xu, Xu, Xu
Uu, Ur^Es, Uu^Vu, Xu, Xu, Qxu, Qxu, Xu, Xu, Xu, Qxu, Qxu, Xu, Xu, Xu, Xu, Xu, Xu, Xu, Xu, Xu, Xu
Uu, Ur, Ur, Qxu, Qxu, Qxu, Xu, Xu, Xu, Xu, Qxu, Xu, Xu, Xu, Xu, Xu, Qxu, Qxu, Qxu, Xu, Xu, Xu
Uh^Es, Uu, Ur^Es, Rd, Uu, Qxu, Uu, Xu, Uh, Uh^Tf, Uh, Qxu, Uh, Uh, Uh, Uu^Vu, Xu, Xu, Qxu, Xu, Xu, Xu
Uh, Uu, Uu, Uu, Uu^Vu, Uu^Es, Uu, Uu, Uu, Uh, Ce, Ce, 2 Ke, Uue, Xu, Xu, Xu, Xu, Qxu, Xu, Xu, Xu
Uh, Uh, Xu, Qxu, Qxu, Uu, Qxu, Uu^Vu, Ur, Rd, Ce, Ce, Rd, Uue, Xu, Xu, Qxu, Qxu, Xu, Qxu, Qxu, Qxu
Xu, Xu, Qxu, Qxu, Xu, Qxu, Xu, Xu, Uh, Ur, Re^Es, Re^Es, Uue, Uu^Vu, Uue, Qxu, Uu^Vu, Xu, Xu, Xu, Qxu, Qxu
Xu, Xu, Xu, Xu, Xu, Qxu, Qxu, Xu, Uh, Uu^Vu, Uue, Uu, Qxu, Qxu, Qxu, Uue, Xu, Uh, Uh^Tf, Uh^Tf, Qxu, Qxu
Xu, Xu, Xu, Xu, Xu, Xu, Xu, Qxu, Uue^Edb, Uue^Edb, Uue, Xu, Xu, Xu, Xu, Xu, Xu, Qxu, Uu^Vu, Uh^Tf, Xu, Xu
Xu, Xu, Wwf, Wwf^Em, Rb^Es, Xu, Uh, Uh, Uue, Uue^Edb, Uue, Qxu, Qxu, Xu, Xu, Xu, Xu, Qxu, Qxu, Uh, Xu, Xu
Wwg, Wwg, Wwf, Wwf, Wwt, Uu^Vu, Wwt, Wwt, Wwt, Ur, Re^Es, Xu, Qxu, Xu, Xu, Xu, Xu, Xu, Xu, Uh, Xu, Xu
Wwg, Wo, Wwf, Wwf, Uu^Tf, Wwt, Uhe, Tb^Tf, Uh, Wwt^Bw|, Wwt, Qxu, Xu, Xu, Xu, Xu, Qxu, Qxu, Rb, Uu, Xu, Xu
Xu, Xu, Xu, Wwf, Uue, Uhe, Xu, Xu, Uu^Vu, Ur, Wwt, Xu, Xu, Xu, Xu, Xu, Qxu, Xu, Xu, Uu^Vu, Qxu, Qxu
Xu, Xu, Uue, Uue, Uu, Qxu, Xu, Xu, Uu, Uu, Wwt, Uh, Qxu, Qxu, Xu, Xu, Qxu, Xu, Xu, Uu, Qxu, Qxu
Xu, Xu, Xu, Xu, Qxu, Qxu^Bcx\, Uu^Ii, Uu^Ii, Rd, Rd, Wwt, Wwt, Uue, Qxu, Uu, Qxu, Xu, Xu, Uh, Uh, Qxu, Qxu
Xu, Xu, Xu, Xu, Uh^Emf, Uh^Tf, Cud, Uu^Ii, 1 Cud, Re^Ii, Re, Wwt, Wwt, Uue, Uu, Uu, Uu, Uu^Vu, Uh^Tf, Qxu, Xu, Xu
Xu, Xu, Xu, Xu, Uh, Uh^Tf, Cud, Kud, Cud, Rd^Ii, Uu, Uu^Ii, Uu^Ii, Wwt, Qxu, Uu, Uh, Uh, Uh^Tf, Uh^Tf, Xu, Xu
Xu, Xu, Qxu, Xu, Qxu, Re, Re^Ii, Uue^Ii, Re^Vct, Uu, Xu, Uu^Vu, Uu^Tf, Qxu, Xu, Xu, Xu, Uh, Qxu, Xu, Xu, Xu
Xu, Xu, Xu, Qxu, Xu, Qxu, Qxu, Uue^Ii, Uue^Ii, Xu, Xu, Xu, Xu, Qxu, Xu, Xu, Xu, Rb^Es, Uu, Qxu, Xu, Xu
Xu, Xu, Xu, Xu, Xu, Xu, Uu^Vud, Uue, Re^Ii, Xu, Xu, Xu, Xu, Qxu, Qxu, Xu, Xu, Rb^Es, Uu^Vu, Qxu, Xu, Xu
Xu, Xu, Xu, Xu, Xu, Xu, Uue^Ii, Uue^Ii, Re^Ii, Re, Uu^Vud, Xu, Xu, Xu, Xu, Xu, Xu, Xu, Xu, Qxu, Qxu, Qxu
Xu, Xu, Xu, Xu, Xu, Xu, Xu, Re, Re, Re^Ii, Uue, Xu, Xu, Xu, Xu, Xu, Xu, Xu, Xu, Qxu, Qxu, Qxu
