Xue, Xue, Xue, Xue, Xue, Xue, Xue, Xue, Xue, Xue, Xue, Xue, Xue, Xue, Xue, Xue, Xue, Xue, Xue, Xue, Xue, Xue, Xue, Xue, Xue, Xue, Xue, Xue, Xue, Xue, Xue, Xue, Xue, Xue, Xue, Xue, Xue, Xue, Xue, Xue, Xue, Xue, Xue, Xue, Xue, Xue
Xue, Xue, Xue, Xue, Xue, Xue, Xue, Xue, Xue, Xue, Xue, Xue, Xue, Xue, Xue, Xue, Xue, Xue, Xue, Xue, Xue, Xue, Xue, Xue, Xue, Xue, Xue, Xue, Xue, Xue, Xue, Xue, Xue, Xue, Xue, Xue, Xue, Xue, Xue, Xue, Xue, Xue, Xue, Xue, Xue, Xue
Xue, Xue, Xue, Xue, Xue, Xue, Xue, Xue, Xue, Xue, Xue, Xue, Xue, Xue, Xue, Xue, Xue, Xue, Xue, Xue, Xue, Xue, Xue, Xue, Xue, Xue, Xue, Xue, Xue, Xue, Xue, Xue, Xue, Xue, Xue, Xue, Xue, Xue, Xue, Xue, Xue, Xue, Xue, Xue, Xue, Xue
Uu, Xue, Xue, Xue, Xue, Xue, Xue, Xue, Xue, Xue, Xue, Xue, Xue, Xue, Xue, Xue, Xue, Xue, Xue, Xue, Xue, Xue, Xue, Xue, Xue, Xue, Xue, Xue, Xue, Xue, Xue, Xue, Xue, Xue, Xue, Xue, Xue, Xue, Xue, Xue, Xue, Xue, Xue, Xue, Xue, Xue
Uu, Uu, Uu, Xue, Uue, Xue, Xue, Xue, Xue, Xue, Xue, Xue, Xue, Xue, Xue, Xue, Xue, Xue, Xue, Xue, Xue, Xue, Xue, Xue, Xue, Xue, Xue, Xue, Xue, Xue, Xue, Xue, Uu^Vu, Uue, Uu^Vu, Xue, Xue, Xue, Xue, Xue, Xue, Xue, Xue, Xue, Xue, Xue
Uu, Uu, Uu, Tb^Tfi, Uue, Uue, Uue, Xue, Xue, Xue, Xue, Xue, Xue, Xue, Xue, Xue, Xue, Xue, Xue, Xue, Xue, Xue, Xue, Xue, Xue, Xue, Xue, Xue, Xue, Xue, Xue, Xue, Uue, Uue, Uue, Urb, Urb^Pr/, Xue, Xue, Xue, Urb, Urb, Urb, Xue, Xue, Xue
Uu, Uu, Qlf, Uu, Uu^Vu, Uue, Uue, Xue, Xue, Xue, Xue, Xue, Xue, Xue, Xue, Xue, Xue, Xue, Xue, Xue, Xue, Xue, Xue, Xue, Xue, Xue, Xue, Xue, Xue, Xue, Xue, Xue, Uue, Uue, Uue, Xue, Xue, Urb, Urb, Urb, Urb, Urb, Urb, Xur, Xur, Xur
Qlf, Qlf, Qlf, Qlf, Uue, Uue, Rb, Uue, Xue, Xue, Xue, Xue, Xue, Xue, Xue, Xue, Xue, Xue, Xue, Xue, Xue, Xue, Xue, Xue, Xue, Xue, Xue, Xue, Xue, Xue, Uue, Uue, Uue, Rb, Uu^Vu, Xue, Xue, Urb, Urb, Urb, Urb, Urb, Urb, Urb, Xur, Xur
Qlf, Qlf, Qlf, Qlf, Qlf, Uue, Rb, Uue, Uue, Uhe, Uue, Uue, Uu^Vu, Xue, Xue, Xue, Xue, Xue, Xue, Xue, Xue, Xue, Xue, Xue, Xue, Xue, Xue, Xue, Uue, Uue, Uue^Ii, Uue, Rb, Rb, Xue, Xue, Xue, Xue, Xue, Xue, Xue, Urb, Xue, Urb, Xur, Xur
Qlf, Qlf, Qlf, Qlf, Qlf, Uue, Uue, Rb, Uue, Uhe, Rb, Uhe, Rb, Xue, Xue, Xue, Xue, Xue, Xue, Xue, Xue, Xue, Xue, Xue, Xue, Xue, Rb, Uue, Rb, Uue, Uue, Uue, Rb, Uue, Uue, Xue, Xue, Xue, Xue, Xue, Xue, Xue, Xue, Xue, Xue, Xue
Qlf, Qlf, Qlf, Qlf, Qlf, Qlf, Qlf, Uue, Uue, Uue, Rb, Rb, Rb, Rb, Uue, Xue, Xue, Xue, Xue, Xue, Xue, Xue, Xue, Xue, Uhe, Rb, Uhe, Rb, Uue, Uue, Xue, Uue, Cte, Cte, Cte, Uhe, Xue, Xue, Xue, Xue, Xue, Xue, Xue, Xue, Xue, Xue
Qlf, Qlf, Qlf, Qlf, Qlf, Qlf, Qlf, Qlf, Xu, Xu, Xue, Uue, Uue, Rb, Uue, Uue, Uue, Xue, Uue, Uue, Uue, Uue, Uue, Uhe, Uue, Rb, Uue, Uue, Xue, Xue, Xue, Xue, Xue, Cte, 4 Kte, Rb, Uhe, Xue, Xue, Xue, Xue, Xue, Xue, Xue, Xue, Xue
Qlf, Qlf, Qlf, Qlf, Qlf, Qlf, Qlf, Qlf, Xu, Xu, Xue, Xue, Xue, Rb, Uue, Uue, Uue, Uue, Rb, Uue, Rb, Uue, Uue, Uue, Uue, Uue, Xue, Xue, Xue, Xue, Xue, Xue, Xue, Xue, Uu^Vu, Rb, Rb, Uue, Uue, Xue, Xue, Xue, Xue, Xue, Xue, Xue
Qlf, Qlf, Qlf, Qlf, Qlf, Qlf, Qlf, Qlf, Xu, Xu, Xue, Xue, Xue, Xue, Xue, Uue, Uue, Uue, Rb, Rb, Uue, Uue, Uue, Uu^Vu, Xue, Xue, Xue, Xue, Xue, Xue, Xue, Xue, Xue, Xue, Xue, Uue, Uue, Rb, Uue, Uue, Uue, Xue, Uu^Vu, Xue, Xue, Xue
Qlf, Qlf, Qlf, Qlf, Qlf, Qlf, Qlf, Qlf, Xu, Xue, Xue, Xue, Xue, Xue, Xue, Xue, Rb, Rb, Uue, Xue, Xue, Xue, Xue, Xue, Xue, Xue, Xue, Xue, Xue, Xue, Xue, Xue, Xue, Xue, Xue, Xue, Xue, Uue, Uue, Uue, Uue, Uue^Br/, Xue, Xue, Xue, Xue
Qlf, Qlf, Qlf, Qlf, Qlf, Qlf, Qlf, Qlf, Qlf, Xu, Xue, Xue, Xue, Xue, Xue, Xue, Uue, Uue, Uue, Xue, Xue, Xue, Xue, Xue, Xue, Xue, Xue, Xue, Xue, Xue, Xue, Xue, Xue, Xue, Xue, Xue, Xue, Xue, Xue, Tb^Tfi, Uue, Uue^Br|, Xue, Xue, Xue, Xue
Qlf, Qlf, Qlf, Qlf, Qlf, Qlf, Qlf, Qlf, Qlf, Xu, Xu, Xue, Xue, Xue, Xue, Xue, Uue, Uue, Uu^Vu, Xue, Xue, Xue, Xue, Xue, Xue, Xue, Xue, Xue, Xue, Xue, Xue, Xue, Xue, Xue, Xue, Xue, Xue, Xue, Xue, Uue, Uue, Uue^Br|, Xue, Xue, Xue, Xue
Qlf, Qlf, Qlf, Qlf, Qlf, Uu^Vu, Qlf, Qlf, Qlf, Qlf, Qlf, Xu, Xu, Xue, Xue, Xue, Rb, Rb, Uue, Xue, Xue, Xue, Xue, Xue, Xue, Xue, Xue, Xue, Xue, Xue, Xue, Xue, Xue, Xue, Xue, Xue, Xue, Xue, Xue, Uue, Uue, Uue^Br|, Uue, Xue, Xue, Xue
Qlf, Qlf, Qlf, Qlf, Qlf, Uh, Uh, Qlf, Qlf, Qlf, Qlf, Qlf, Qlf, Xu, Xu, Uue, Rb, Uue, Xue, Xue, Xue, Xue, Xue, Xue, Xue, Xue, Xue, Xue, Xue, Xue, Xue, Xue, Xue, Xue, Xue, Xue, Xue, Xue, Xue, Uue, Uue, Rb^Br|, Uue, Xue, Xue, Xue
Qlf, Qlf, Qlf, Qlf, Uh, Cte, Cte, Qlf, Qlf, Qlf, Qlf, Qlf, Qlf, Qlf, Qlf, Uue, Rb, Rb, Xue, Xue, Xue, Xue, Xue, Xue, Xue, Xue, Xue, Xue, Xue, Xue, Xue, Xue, Xue, Xue, Xue, Xue, Xue, Xue, Xue, Xue, Rb, Rb^Br|, Uue, Xue, Xue, Xue
Qlf, Qlf, Qlf, Qlf, Uh, 2 Kte, Uh, Qlf, Qlf, Qlf, Qlf, Qlf, Qlf, Qlf, Uue, Uue, Uue, Uue, Uue, Xue, Xue, Xue, Xue, Xue, Xue, Xue, Xue, Xue, Xue, Xue, Xue, Xue, Xue, Xue, Xue, Xue, Xue, Xue, Xue, Xue, Rb, Uue^Br|, Uue, Xue, Xue, Xue
Qlf, Qlf, Qlf, Qlf, Qlf, Uh, Qlf, Qlf, Qlf, Qlf, Qlf, Qlf, Qlf, Qlf, Uue, Uue, Uue, Uue, Qlf, Xue, Qlf, Xue, Xue, Xue, Xue, Xue, Xue, Xue, Xue, Xue, Xue, Xue, Xue, Xue, Xue, Xue, Xue, Xue, Xue, Xue, Uue, Uue^Br|, Uue, Xue, Xue, Xue
Qlf, Qlf, Qlf, Qlf, Qlf, Qlf, Qlf, Qlf, Qlf, Qlf, Qlf, Qlf, Qlf, Qlf, Qlf, Qlf, Qlf^Bh|, Qlf, Qlf, Qlf, Qlf, Qlf, Qlf, Xue, Xue, Xue, Xue, Xue, Xue, Xue, Xue, Xue, Xue, Xue, Xue, Xue, Xue, Xue, Xue, Xue, Uue, Uue^Br|, Uu^Vu, Xue, Xue, Xue
Qlf, Qlf, Qlf, Qlf, Qlf, Qlf, Qlf, Qlf, Qlf, Qlf, Qlf, Qlf, Qlf, Qlf, Qlf, Qlf, Qlf^Bh|, Qlf, Qlf, Qlf, Qlf, Qlf, Qlf, Xue, Xue, Xue, Xue, Xue, Xue, Xue, Xue, Xue, Xue, Xue, Xue, Xue, Xue, Xue, Uue^Br/, Xue, Uue^Br/, Uu^Br/, Uue, Xue, Xue, Xue
Qlf, Qlf, Qlf, Qlf, Qlf, Qlf, Qlf, Qlf, Qlf, Qlf, Qlf, Qlf, Qlf, Qlf, Qlf, Qlf, Qlf^Bh|, Qlf, Xue, Qlf, Qlf, Qlf, Qlf, Xue, Xue, Xue, Xue, Xue, Xue, Xue, Xue, Xue, Xue, Xue, Xue, Xue, Uue^Br/, Uue^Br/, Uue, Uue^Br\, Rb, Uue, Uue, Xue, Xue, Xue
Qlf, Qlf, Qlf, Qlf, Qlf, Qlf, Qlf, Qlf, Qlf, Qlf, Qlf, Qlf, Qlf, Qlf, Qlf, Qlf, Qlf^Bh|, Qlf, Qlf, Qlf, Qlf, Qlf, Xue, Xue, Xue, Xue, Xue, Xue, Xue, Xue, Xue, Xue, Uue^Br/, Uue^Br/, Uue^Br\, Uue^Br/, Uue, Uue, Uue, Xue, Uue, Rb, Rb, Xue, Xue, Xue
Qlf, Qlf, Qlf, Qlf, Qlf, Qlf, Qlf, Qlf, Qlf, Qlf, Qlf, Qlf, Qlf, Qlf, Qlf, Qlf, Qlf^Bh|, Qlf, Qlf, Qlf, Qlf, Qlf, Xue, Xue, Xue, Xue, Xue, Xue, Xue, Xue, Uue^Br/, Uue^Br/, Uue, Uue, Uue, Xue, Xue, Uue, Xue, Uue, Uue, Rb, Rb, Xue, Xue, Xue
Qlf, Qlf, Qlf, Qlf, Qlf, Qlf, Qlf, Qlf, Qlf, Qlf, Qlf, Qlf, Qlf, Qlf, Uue, Qlf, Qlf^Bh|, Qlf, Qlf, Qlf, Xue, Xue, Xue, Xue, Xue, Xue, Xue, Xue, Uue^Br|, Uue^Br/, Uue, Xue, Uue, Uue, Xue, Xue, Xue, Xue, Uue, Uue, Uue, Uhe, Uue, Xue, Xue, Xue
Qlf, Qlf, Qlf, Qlf, Qlf, Qlf, Qlf, Qlf, Qlf, Qlf, Qlf, Qlf, Qlf, Qlf, Uue, Uue, Uue^Br|, Uue, Xue, Xue, Xue, Xue, Xue, Xue, Xue, Xue, Xue, Uue, Uue^Br/, Xue, Uue, Uue, Xue, Xue, Xue, Xue, Xue, Uue, Uue, Uue, Uue, Uhe, Xue, Xue, Xue, Xue
Qlf, Qlf, Qlf, Qlf, Qlf, Qlf, Qlf, Qlf, Qlf, Qlf, Qlf, Qlf, Qlf, Qlf, Xue, Uue^Emf, Uue^Br|, Uue^Br\, Uue^Br\, Xue, Xue, Xue, Uue, Xue, Uue^Br/, Xue, Uue^Br/, Uue^Br/, Xue, Uue, Uue, Xue, Xue, Xue, Xue, Xue, Uue, Uue, Uue, Uue, Tb^Tfi, Xue, Xue, Xue, Xue, Xue
Qlf, Qlf, Qlf, Qlf, Xue, Xue, Xue, Qlf, Qlf, Qlf, Qlf, Qlf, Xue, Xue, Xue, Uu^Vud, Uue^Br|, Uue^Br/, Xue, Uue^Br\, Uue^Br\, Uue, Uue^Br/, Uue^Br/, Uue, Uue^Br\, Xue, Xue, Xue, Xue, Xue, Xue, Xue, Xue, Xue, Xue, Uue, Uue, Uue, Uue, Xue, Xue, Xue, Xue, Xue, Xue
Xue, Qlf, Xue, Xue, Xue, Xue, Xue, Xue, Xue, Qlf, Xue, Xue, Xue, Xue, Xue, Uue, Uue^Br|, Tb^Ii, Xue, Uue, Xue, Uue^Br/, Uue, Xue, Uue, Xue, Xue, Xue, Xue, Xue, Xue, Xue, Xue, Xue, Xue, Uu^Vu, Uue, Uue, Uue, Xue, Xue, Xue, Xue, Xue, Xue, Xue
Xue, Xue, Xue, Xue, Xue, Xue, Xue, Xue, Xue, Xue, Xue, Xue, Xue, Xue, Xue, Uue, Uue^Br|, Tb^Tf, Xue, Xue, Xue, Xue, Uue, Uue, Uue, Xue, Uue, Xue, Xue, Xue, Xue, Xue, Xue, Xue, Xue, Uhe, Uue, Rb, Xue, Xue, Xue, Xue, Xue, Xue, Xue, Xue
Xue, Xue, Xue, Xue, Xue, Xue, Xue, Xue, Xue, Xue, Xue, Xue, Xue, Xue, Xue, Uue, Uue^Br|, Uue, Xue, Xue, Xue, Xue, Xue, Uue, Uue, Uue, Uu^Vu, Xue, Xue, Xue, Xue, Xue, Xue, Xue, Uue, Uhe, Uhe, Rb, Xue, Xue, Xue, Xue, Xue, Xue, Xue, Xue
Xue, Xue, Xue, Xue, Xue, Xue, Xue, Xue, Xue, Xue, Xue, Xue, Xue, Xue, Uue, Uue, Uue^Br|, Uue, Xue, Xue, Xue, Xue, Xue, Xue, Xue, Uue, Xue, Xue, Xue, Xue, Xue, Xue, Xue, Xue, Uhe, Uhe, Uhe, Uue, Xue, Xue, Xue, Xue, Xue, Xue, Xue, Xue
Xue, Xue, Xue, Xue, Xue, Xue, Xue, Xue, Uue, Uue, Uue, Uu^Vud, Uue^Emf, Uue, Xue, Uue, Uue^Br|, Uue, Xue, Xue, Xue, Xue, Xue, Xue, Xue, Xue, Xue, Xue, Xue, Xue, Xue, Xue, Xue, Xue, Uue, Uue, Uue, Uue, Xue, Xue, Xue, Xue, Xue, Xue, Xue, Xue
Xue, Xue, Xue, Xue, Xue, Xue, Xue, Xue, Xue, Uue, Uue, Uue, Xue, Xue, Xue, Uue, Uue^Br|, Uue, Xue, Xue, Xue, Xue, Xue, Xue, Xue, Xue, Xue, Xue, Xue, Xue, Xue, Xue, Xue, Xue, Tb^Tfi, Uue, Uue, Uue, Xue, Xue, Xue, Xue, Xue, Xue, Xue, Xue
Xue, Xue, Xue, Xue, Xue, Xue, Xue, Xue, Xue, Uue, Uue, Uue, Xue, Xue, Xue, Uue, Uue^Br|, Uue, Xue, Xue, Xue, Xue, Xue, Xue, Xue, Xue, Xue, Xue, Xue, Xue, Xue, Xue, Xue, Xue, Xue, Uue, Uue, Uue, Uue, Xue, Xue, Xue, Xue, Xue, Xue, Xue
Xue, Xue, Xue, Xue, Xue, Xue, Xue, Xue, Xue, Xue, Uue, Uue, Xue, Xue, Uu^Vud, Uue, Uue^Br|, Uue, Xue, Xue, Xue, Xue, Xue, Xue, Xue, Xue, Xue, Xue, Xue, Xue, Xue, Xue, Xue, Xue, Xue, Uue, Uue, Uue, Uue, Xue, Xue, Xue, Xue, Xue, Xue, Xue
Xue, Xue, Xue, Xue, Xue, Xue, Xue, Xue, Xue, Xue, Xue, Uue, Xue, Xue, Uue^Br|, Uue^Br/, Cud, Uue, Xue, Xue, Xue, Xue, Xue, Xue, Xue, Xue, Xue, Xue, Uue, Xue, Xue, Xue, Xue, Xue, Xue, Xue, Uue, Uue, Uue, Xue, Xue, Xue, Xue, Xue, Xue, Xue
Xue, Xue, Xue, Xue, Xue, Xue, Xue, Xue, Xue, Xue, Xue, Uue, Uue, Xue, Uue^Br|, Cud, Cud, Cud, Xue, Xue, Xue, Xue, Xue, Xue, Xue, Xue, Xue, Xue, Uue, Uu^Vu, Xue, Xue, Xue, Xue, Xue, Uue, Uue, Uue, Uu^Vu, Xue, Xue, Xue, Xue, Xue, Xue, Xue
Xue, Xue, Xue, Xue, Xue, Xue, Xue, Xue, Xue, Xue, Xue, Xue, Uue, Xue, Uue^Br|, Cud, Cud, Xue, Xue, Xue, Uu^Vud, Xue, Xue, Xue, Xue, Xue, Xue, Xue, Uhe, Uhe, Uue, Xue, Xue, Xue, Xue, Xue, Xue, Uue, Uue, Uue, Xue, Xue, Xue, Xue, Xue, Xue
Xue, Xue, Xue, Xue, Xue, Xue, Xue, Xue, Xue, Xue, Xue, Xue, Xue, Cud, Uue^Br|, 1 Kud, Cud, Cud, Uue, Uue, Xue, Xue, Xue, Xue, Xue, Xue, Xue, Xue, Uue, Xue, Uue, Xue, Xue, Xue, Xue, Xue, Xue, Uue, Uue, Uue, Xue, Xue, Xue, Xue, Xue, Xue
Xue, Xue, Xue, Xue, Xue, Xue, Xue, Xue, Xue, Xue, Xue, Xue, Uue, Cud, Uue^Br|, Cud, Xue, Xue, Uue, Xue, Xue, Xue, Xue, Xue, Rb, Xue, Xue, Xue, Uue, Xue, Xue, Uue, Xue, Xue, Xue, Xue, Xue, Uue, Rb, Uu^Vu, Xue, Xue, Xue, Xue, Xue, Xue
Xue, Xue, Xue, Xue, Xue, Xue, Xue, Xue, Xue, Xue, Xue, Xue, Uue, Uue, Uue^Br|, Cud, Xue, Xue, Uue, Uue, Uue, Xue, Uue, Uue, Rb, Rb, Uhe, Uue, Uue^Ii, Uue, Uue, Uue, Xue, Uue^Ii, Tb^Tf, Xue, Uue, Uue, Rb, Uue, Xue, Xue, Xue, Xue, Xue, Xue
Xue, Xue, Xue, Xue, Xue, Xue, Xue, Xue, Xue, Xue, Uu^Vud, Uue, Uue^Br/, Uue^Br/, Uu^Vud, Xue, Xue, Xue, Xue, Uue, Uue^Ii, Uue, Uue, Xue, Uue, Rb, Xue, Uue, Xue, Xue, Uue, Uue, Uue, Uue, Rb, Uue, Xue, Cte, 3 Kte, Cte, Xue, Xue, Xue, Xue, Xue, Xue
Xue, Xue, Xue, Xue, Xue, Xue, Xue, Xue, Xue, Xue, Uu^Br|, Uue^Br/, Uue, Uue, Xue, Xue, Xue, Xue, Xue, Xue, Uue, Uue, Uue, Xue, Uue, Uue, Xue, Xue, Xue, Xue, Xue, Uue, Uu^Vu, Rb, Rb, Uue, Rb, Cte, Uue, Cte, Uue, Xue, Xue, Xue, Xue, Xue
Xue, Xue, Xue, Xue, Xue, Xue, Xue, Xue, Uhe, Xue, Uue^Br|, Uue, Xue, Xue, Xue, Xue, Xue, Xue, Xue, Xue, Xue, Uue, Uue, Xue, Uu^Vu, Xue, Xue, Xue, Xue, Xue, Xue, Xue, Xue, Xue, Xue, Rb, Xue, Xue, Uue, Uhe, Uue, Xue, Xue, Xue, Xue, Xue
Xue, Xue, Xue, Xue, Xue, Xue, Xue, Xue, Uhe, Uhe, Uue^Br|, Uue, Uue, Xue, Xue, Xue, Xue, Xue, Xue, Xue, Xue, Xue, Xue, Uue, Xue, Xue, Xue, Xue, Xue, Xue, Xue, Xue, Xue, Xue, Xue, Xue, Xue, Xue, Uhe, Rb, Rb, Xue, Xue, Xue, Xue, Xue
Xue, Xue, Xue, Xue, Xue, Xue, Xue, Xue, Uue, Uue, Uue^Br|, Uue, Uue, Xue, Xue, Xue, Xue, Xue, Xue, Xue, Xue, Xue, Xue, Xue, Xue, Xue, Xue, Xue, Xue, Xue, Xue, Xue, Xue, Xue, Xue, Xue, Xue, Xue, Uue, Uu^Vu, Uue, Rb, Xue, Xue, Xue, Xue
Xue, Xue, Xue, Xue, Xue, Xue, Uue, Xue, Uue, Uhe, Uu^Br|, Uue, Xue, Xue, Xue, Xue, Xue, Xue, Xue, Xue, Xue, Xue, Xue, Xue, Xue, Xue, Xue, Xue, Xue, Xue, Xue, Xue, Xue, Xue, Xue, Xue, Xue, Xue, Uue, Uhe, Uue, Uue, Uue, Xue, Xue, Xue
Xue, Xue, Xue, Xue, Uue, Uue, Uhe, Uhe, Uue^Br/, Uue^Br/, Xue, Xue, Xue, Xue, Xue, Xue, Xue, Xue, Xue, Xue, Xue, Xue, Xue, Xue, Xue, Xue, Xue, Xue, Xue, Xue, Xue, Xue, Xue, Xue, Xue, Xue, Xue, Xue, Xue, Uue, Uue, Uu^Vu, Uue, Uue, Uue, Xue
Xue, Xue, Uhe, Uue, Uhe, Uhe, Uue^Br/, Uue^Br/, Uu^Vud, Xue, Xue, Xue, Xue, Xue, Xue, Xue, Xue, Xue, Xue, Xue, Xue, Xue, Xue, Xue, Xue, Xue, Xue, Xue, Xue, Xue, Xue, Xue, Xue, Xue, Xue, Xue, Xue, Xue, Xue, Uue, Uue, Uue, Uue, Uue, Uue, Uue
Xue, Xue, Uhe, Uhe, Uue, Uue^Br/, Uue, Uue, Xue, Xue, Xue, Xue, Xue, Xue, Xue, Xue, Xue, Xue, Xue, Xue, Xue, Xue, Xue, Xue, Xue, Xue, Xue, Xue, Xue, Xue, Xue, Xue, Xue, Xue, Xue, Xue, Xue, Xue, Xue, Xue, Xue, Xue, Xue, Uue, Uue, Uue
