Xu, Xu, Xu, Xu, Xu, Xu, Xu, Xu, Xu, Xu, Xu, Wog, Xu, Xu, Xu, Xu, Xu, Xu, Xu, Xu, Xu, Xu, Xu, Xu
Xu, Xu, Xu, Xu, Xu, Xu, Xu, Xu, Xu, Xu, Xu, Wog, Xu, Xu, Xu, Xu, Xu, Xu, Xu, Xu, Xu, Xu, Xu, Xu
Xu, Xu, Xu, Xu, Xu, Xu, Xu, Xu, Xu, Xu, Xu, Wog, Wog, Xu, Xu, Xu, Xu, Xu, Xu, Xu, Xu, Xu, Xu, Xu
Xu, Xu, Xu, Xu, Xu, Xu, Xu, Xu, Xu, Xu, Xu, Xu, Xu, Wog, Wog, Xu, Xu, Xu, Xu, Xu, Xu, Xu, Xu, Xu
Xu, Xu, Xu, Xu, Xu, Xu, Xu, Xu, Xu, Xu, Xu, Xu, Xu, Xu, Wog^Xo, Xu, Xu, Xu, Qxu, Xu, Qxu, Xu, Xu, Xu
Ur^Br\, Uu, Uu, Xu, Xu, Xu, Xu, Xu, Cud, Cud, Cud, Xu, Xu, Xu, Wog, Xu, Xu, Qxu, Qxu, Qxu, Qxu, Xu, Uu, Uu
Uu, Ur^Br\, Cud, Cud, Ur^Br\, Uh, Uh^Tf, Uh^Tf, Uu, Ket, Uh, Xu, Xu, Wwg, Wwg, Xu, Cud, Qxu, Uh, Uh, Uh, Cud, Cud, Urb
Xu, Cud, Uh^Ii, Uu^Ii, Uu^Ii, Ur^Br\, Uu, Uu, Cud, Uu, Uu, Tb^Tf, Uu^Tf, Tb^Tf, Wwf^Es, Wwf, Tb^Tf, Uh^Tf, Ce, Ce^Es, Ce^Ecf, Ur, Uu, Cud
Xu, Xu, Uh^Tf, Uh^Ii, Uu^Ii, Ur^Br|, Ur^Br\, Cud, 2 Kud, Cud, Ur, Uu^Tf, Ur, Uu^Es, Ur^Es, Wwf, Ur, Ur, Ce^Ii, 1 Ke, Ce, Ur, Uu, Xu
Xu, Xu, Xu, Uu^Tf, Uh, Uu, Uh, Cud, Cud, Cud, Uue, Ur, Ur^Es, Ur, Ur, Wwf^Es, Wwf, Re, Uu^Ii, Ce, Uu, Uu, Xu, Xu
Xu, Xu, Xu, Xu, Cud, Uh, Uue, Uue, Rb^Emf, Uue, Re^Em, Uue^Es, Uu, Uh, Uh^Tf, Tb^Tf, Tb^Tf, Wwf^Ii, Wwg, Uu, Uu, Xu, Xu, Xu
Xu, Xu, Xu, Xu, Xu, Cud, Cud, Rb^Em, Re^Emf, Rb^Emf, Qxu, Qxu, Qxu, Uh^Tf, Qxu, Tb^Tf, Xu, Cud, Xu, Wwg, Xu, Xu, Xu, Xu
Xu, Xu, Xu, Xu, Xu, Xu, Xu, Re^Emf, Re^Emf, Re^Emf, Qxu, Qxu, Qxu, Qxu, Xu, Xu, Xu, Xu, Xu, Wog^Xo, Xu, Xu, Xu, Xu
Xu, Xu, Xu, Xu, Xu, Xu, Xu, Qxu, Qxu, Qxu, Qxu, Qxu, Xu, Qxu, Xu, Xu, Xu, Xu, Xu, Wog, Wog, Xu, Xu, Xu
Xu, Xu, Xu, Xu, Xu, Xu, Xu, Xu, Xu, Xu, Xu, Xu, Xu, Xu, Xu, Xu, Xu, Xu, Xu, Xu, Xu, Wog, Wog, Xu
Xu, Xu, Xu, Xu, Xu, Xu, Xu, Xu, Xu, Xu, Xu, Xu, Xu, Xu, Xu, Xu, Xu, Xu, Xu, Xu, Xu, Xu, Xu, Wog
Xu, Xu, Xu, Xu, Xu, Xu, Xu, Xu, Xu, Xu, Xu, Xu, Xu, Xu, Xu, Xu, Xu, Xu, Xu, Xu, Xu, Xu, Xu, Xu
Xu, Xu, Xu, Xu, Xu, Xu, Xu, Xu, Xu, Xu, Xu, Xu, Xu, Xu, Xu, Xu, Xu, Xu, Xu, Xu, Xu, Xu, Xu, Xu
Xu, Xu, Xu, Xu, Xu, Xu, Xu, Xu, Xu, Xu, Xu, Xu, Xu, Xu, Xu, Xu, Xu, Xu, Xu, Xu, Xu, Xu, Xu, Xu
Xu, Xu, Xu, Xu, Xu, Xu, Xu, Xu, Xu, Xu, Xu, Xu, Xu, Xu, Xu, Xu, Xu, Xu, Xu, Xu, Xu, Xu, Xu, Xu
