Ms, Ms, Ms, Ms, Ms, Ms, Ms, Ms, Ms, Ms, Ms, Ms, Ms, Ms, Ms, Ms, Ms, Aa, Xoa, Xoa, Xoa, Xoa, Xoa, Xoa, Xoa, Xoa, Xoa, Xoa, Xoa, Xoa, Xoa, Xoa, Aa, Aa^Fpa, Aa^Fpa, Aa^Fpa, Aa^Fpa, Aa^Fpa, Aa^Fpa, Aa^Fpa, Ms, Ms, Ms, Ms, Ms, Ms, Ms, Aa^Fpa, Ms, Ms, Ms, Aa^Fpa, Ms, Ms, Ms, Aa^Fpa, Ms, Aa^Fpa
Ms, Ms, Ms, Ms, Ms, Ms, Ms, Ms, Ms, Ms, Ms, Ms, Ms, Ms, Ms, Ms, Ms, Aa, Xoa, Xoa, Xoa, Xoa, Xoa, Xoa, Xoa, Xoa, Xoa, Xoa, Iwo, Xoa, Xoa, Xoa, Xoa, Aa, Aa, Aa^Fpa, Aa^Fpa, Aa^Fpa, Aa^Vaa, Aa^Fpa, Ms, Ms, Ms, Ms, Ms, Ms, Ms, Ms, Ms, Ms, Ms, Ms, Ms, Ms, Ms, Ms, Ms, Ms
Ms, Ms, Ms, Ms, Ms, Ms, Ms, Ms, Ms, Ms, Ms, Ms, Ms, Ms, Ms, Ms, Ms, Ms, Xoa, Xoa, Exos, Xoa, Xoa, Xoa, Xoa, Xoa, Isa, Iwo, Urc, Iwo, Isa, Xoa, Xoa, Xoa, Aa, Aa^Fpa, Aa^Fpa, Aa^Fpa, Aa, Aa, Aa, Ms, Ms, Ms, Ms, Ms, Ms, Ms, Ms, Ms, Ms, Ms, Ms, Ms, Ms, Ms, Ms, Ms
Ms, Ms, Ms, Ms, Ms, Ms, Ms, Ms, Ms, Ms, Ms, Ms, Ms, Ms, Ms, Ms, Ms, Xoa, Xoa, Exos, Urc, Urc, Urb, Exos, Exos, Exos, Isa, Urc, Urc, Urc, Xoa, Xoa, Urc, Xoa, Aa^Dr, Aa, Aa, Aa^Fpa, Aa^Fpa, Aa, Aa^Fpa, Aa^Fpa, Aa^Vaa, Aa^Fpa, Aa, Aa, Aa^Fpa, Aa^Fpa, Aa^Fpa, Ms, Ms, Ms, Ms, Ms, Ms, Ms, Ms, Ms
Ms, Ms, Ms, Ms, Ms, Ms, Ms, Ms, Ms^Xm, Ms^Xm, Ms^Xm, Ms^Xm, Ms^Xm, Ms, Ms, Ms, Ms, Ha, Ha, Urc^Dr, Isa, Urc, Urb, Xoa, Xoa, Xoa, Xoa, Iwo, Iwo, Xoa, Urc, Urc, Urc, Urc, Xoa, Xoa, Aa, Aa^Fpa, Aa, Aa^Fpa, Aa^Fpa, Aa^Fpa, Aa^Fpa, Aa, Aa, Aa, Aa^Fpa, Aa^Fpa, Aa^Fpa, Aa, Ms, Ms, Ms, Ms, Ms, Ms, Ms, Ms
Ms, Ms, Ms, Ms, Ms, Ms, Ms, Ms^Xm, Ms^Xm, Ms^Xm, Ms^Xm, Ms^Xm, Ms^Xm, Ms, Ms, Ms, Ha, Ha, Ha, Isa^Dr, Isa, Xoa, Xoa, Xoa, Xoa, Xoa, Xoa, Xoa, Iwo, Iwo, Iwo, Urc, Xoa, Xoa, Xoa, Xoa, Xoa, Aa, Aa, Aa, Aa^Fpa, Aa^Fpa, Aa^Fpa, Aa^Fpa, Aa^Fpa, Aa^Fpa, Aa^Fpa, Aa^Fpa, Aa, Aa, Aa, Ms, Aa, Ms, Ms, Ms, Ms, Ms
Ms, Ms, Ms, Ms, Ms, Ms, Ms, Ms, Ms, Ms^Xm, Ms^Xm, Ms^Xm, Ms, Ms, Ms, Ms, Ha, Ha, Xoa, Xoa, Exos, Xoa, Xoa, Xoa, Xoi, Xoi, Xoa, Isa, Iwo, Isa, Xoa, Xoa, Xoa, Xoa, Xoa, Xoa, Rr, Xoa, Xoa, Aa, Aa, Aa, Aa, Aa^Fpa, Aa^Fpa, Aa^Fpa, Aa, Aa, Ha, Aa, Ha, Ha, Aa, Aa, Aa^Fpa, Ms, Ms, Ms
Ms, Ms, Ms, Ms, Ms^Xm, Ms, Ms, Ms, Ms, Ms^Xm, Ms, Ms^Xm, Ms, Ms, Xoa, Ms, Xoa, Xoa, Xoa, Xoa, Urb, Urb, Urb, Xoa, Xoa, Xoa, Xoa, Xoa, Xoa, Isa, Isa, Isa^Edb, Xoa, Xoa, Rr, Rr, Isa^Ii, Rr, Rr, Xoa, Xoa, Aa, Aa, Aa, Aa, Aa^Fpa, Aa, Ha, Ha, Aa, Aa, Aa, Aa^Fpa, Aa^Fpa, Aa^Fpa, Ha^Fpa, Aa, Aa
Ms, Ms, Ms^Xm, Ms^Xm, Ms^Xm, Ms^Xm, Ms, Ms, Ms, Ms, Ms, Ms, Ms, Xoa, Xoa, Xoa, Xoa, Xoa, Urb, Urb, Urb, Rr, Urb, Urb, Urb, Xoa, Urb, Urb, Urb, Isa, Isa, Isa^Edt, Xoa, Rr, Isa, Isa^Dr, Isa, Isa, Rr, Rr, Xoa, Xoa, Xoa, Aa, Aa, Aa, Aa, Aa, Ha, Aa, Ha, Aa, Aa^Fpa, Aa^Fpa, Aa^Fpa, Aa^Vka, Aa, Aa
Ms, Ms^Xm, Ms^Xm, Ms^Xm, Ms^Xm, Ms, Ms, Ms, 3 Ms, Ms, Ms, Ms, Xoa, Xoa, Xoa, Xoa, Urb, Urb, Urb, Rr, Urb, Urb, Urb, Xoa, Urb, Urb, Xoa, Xoa, Xoa, Uu, Isa^Edt, Isa, Isa, Xoa, Isa, Isa, Rr, Rr, Xoa, Xoa, Rr, Rr, Isa, Xoa, Xoa, Aa, Aa, Aa, Aa, Ha, Aa^Vka, Aa, Aa, Aa^Fpa, Aa^Fpa, Aa, Ha, Ha
Ms, Ms^Xm, Ms^Xm, Ms^Xm, Ms, Ms, Ms, Ms, Ms, Ms, Xoa, Xoa, Xoa, Xoa, Xoa, Xoa, Urb^Dr, Rr, Urb, Urb, Urb, Urb, Urb, Urb, Urb, Xoa, Chr, 2 Khr, Chr, Xoa, Xoa, Isa, Isa, Isa, Isa, Xoa, Xoa, Xoa, Rr, Rr, Isa, Isa^Ii, Isa, Isa, Rr, Xoa, Aa, Aa^Feta, Aa, Aa, Aa, Aa, Ha, Aa, Aa, Aa, Ha, Ha
Ms, Ms^Xm, Ms, Ms, Ms, Ms, Ms, Ms, Xoa, Xoa, Xoa, Xoa, Xoa, Xoa, Xoa, Xoa, Urb, Urb, Urb, Xoa, Urb, Urb, Xoa, Urb, Isa, Xoa, Xoa, Uhe^Dr, Urb, Urb, Urb^Edt, Urb, Xoa, Isa, Isa, Isa, Isa^Edt, Xoa, Xoa, Isa, Isa, Isa^Ii, Rr, Rr, Xoa, Xoa, Aa, Aa, Ha, Aa, Aa, Ha, Aa, Aa, Ha, Ha, Ha, Ha
Ms, Ms, Ms, Ms, Ms, Ms, Ms, Ms, Xoa, Xoa, Xoa, Xoa, Xoa, Xoa, Isa, Isa^Dr, Urc, Xoa, Xoa, Urb, Xoa, Xoa, Exos^Dr, Isa, Isa, Isa, Isa, Isa, Exos, Xoa, Xoa, Urb, Urb, Xoa, Xoa, Isa, Isa^Edb, Isa^Edt, Isa^Edb, Isa, Xoa, Rr, Xoa, Uh^Dr, Aa, Aa, Aa, Ha, Ha, Ha, Aa, Ha, Ha, Ha, Aa, Ha, Ha, Ha
Ms, Ms, Ms, Ms, Ms, Ms, Ms, Xoa, Xoa, Xoa, Xoa, Xoa, Isa, Isa, Isa, Isa, Urc, Urc, Urc, Xoa, Exos^Dr, Exos^Dr, Urb, Xoa, Isa, Isa^Ii, Xoa, Exos, Exos, Isa, Isa^Dr, Xoa, Xoa, Exos, Exos, Xoa, Xoa, Isa, Uu, Ur, Isa, Xoa, Uh^Edb, Aa, Aa, Aa, Aa^Voa, Aa, Aa, Ha, Ha, Ha, Ha, Aa, Aa, Ha, Ha, Ha
Ms, Ms, Ms, Ms, Ms, Ms, Ms, Xoa, Xoa, Xoi, Xoa, Isa, Urc, Isa, Urc, Urc, Urc, Urc, Xoa, Xoa, Xoa, Urb, Urb, Urb, Xoa, Isa, Isa^Edt, Xoa, Xoa, Isa^Edt, Isa, Isa, Rr, Rr, Exos, Xoa, Xoa, Xoa, Xoa, Isa, Uu, Isa, Uue^Ii, Exos, Aa, Aa, Aa, Aa, Aa, Aa, Ha^Fpa, Ha^Fpa, Ha, Aa, Aa, Aa, Aa, Ha
Ms, Ms, Ms, Ms, Ms, Ms, Ms, Xoa, Xoa, Xoi, Xoa, Xoa, Urc, Urc, Urc, Urc, Isa^Dr, Xoa, Urb^Edt, Urb, Urb, Xoa, Xoa, Xoa, Uu, Xoa, Xoa, Isa^Edt, Xoa, Xoa, Xoa, Xoa, Xoa, Xoa, Isa, Xoa, Xoa^Efs, Xoa, Xoa, Xoa, Xoa, Wwf, Ur, Exos, Ha, Aa, Ha, Aa, Aa, Aa, Aa^Fpa, Ha^Fpa, Aa^Fpa, Aa^Fpa, Aa, Aa^Vka, Ha, Ha
Ms, Ms, Ms, Ms, Ms, Ms, Ms, Xoa, Xoa, Xoa, Xoa, Xoa, Xoa, Urc, Urc, Isa^Dr, Xoa, Urb, Urb, Urb, Xoa, Xoa, Uu, Uu, Xoa, Uu^Qhh, Xoa, Uu, Uu, Isa, Isa, Xoa, Isa, Isa, Isa, Urc, Urc, Xoa, Xoa, Xoa, Xoa, Xoa, Ur, Exos, Ha, Ha, Ha, Aa, Aa, Aa, Aa, Aa, Ha, Ha, Ha, Ha, Ha, Ha
Ms, Ms, Ms, Ms, Ms, Ms, Ms, Ms, Xoa, Xoa, Xoa, Xoa, Xoa^Efs, Xoa, Urb, Uu, Urb, Urb^Edt, Xoa, Xoa, Uu^Vu, Xoa, Xoa, Ur, Ur^Edb, Xoa, Uu, Uu, Uu, Xoa, Xoa, Isa, Urc, Urc, Urc, Urc, Rr^Dr, Xor, Ai^Qhu, Aa, Aa, Xoa, Ur, Exos, Ha, Ha, Aa, Aa, Aa, Aa, Ha, Aa, Ha, Ha^Vka, Ha, Ha, Ha, Ha
Ms, Ms, Ms, Ms, Ms, Ms, Ms, Ms, Ms, Xoa, Xoa, Xoa, Xoa, Urb, Urb^Edb, Urb, Urb, Xoa, Xoa, Uu^Qhh, Uu^Qhh, Ur, Xoa, Xoa, Ur^Ii, Rp, Uu^Qhu, Xoa, Xoa, Xoa, Uu, Xoa, Xoa, Urc, Rr^Dr, Rr^Dr, Rra, Rra, Rra^Esa, Rra, Rra^Esa, Aa, Ha, Exos, Ha, Ha, Ha, Aa, Ha, Ha, Ha, Ha, Ha, Ha, Ha, Ha, Ha, Ha
Ms, Ms, Ms, Ms, Ms, Ms, Ms, Ms, Ms, Ms, Ms, Xoa, Xoa, Xoa, Xoa, Urb, Urb, Urb, Urb, Xoa^Efs, Xoa, Ur^Ii, Ur^Dr, Ur^Edb, Ur^Dr, Xoa, Xoa, Uu^Qhu, Xoa, Uu, Uu, Uu^Qhu, Xoa, Xoa, Rra, Ur^Ii, Ur, Rra, Rra, Rra, Re^Vct, Rra, Ha, Ha, Ha, Ha, Ha, Ha, Aa, Ha, Aa, Aa, Ha, Ha, Ha^Qhh, Ha, Ha^Esa, Ha^Qhh
Ms, Ms, Ms, Ms, Ms, Ms, Ms, Ms, Ms, Ms, Ms, Ms, Ms, Xoa, Xoa, Xoa, Xoa, Urb, Urb, Urb, Urb, Ur^Dr, Ur, Ur^Edt, Ur, Ur, Xoa, Urb, Urb, Urb, Xoa, Xoa, Xoa, Rra, Aa, Aa, Rra^Esa, Ur^Ii, Re^Vct, Rra, Rra, Rra, Rra, Aa, Aa, Ha, Aa, Ha, Aa, Aa, Aa, Aa, Ha^Qhh, Ha^Qhh, Ha^Qhh, Ha, Ha^Fdw, Ha^Fdw
Ms, Ms, Ms^Xm, Ms^Xm, Ms^Xm, Ms, Ms, Ms, Ms, Ms, Ms, Ms, Ms, Xoa, Xoa, Xoa, Xoa, Xoa, Urb, Urb, Xor, Urb^Edt, Urb, Xoa^Efs, Xoa, Xoa, Urb, Urb, Urb, Urb, Xoa, Xoa, Xoa, Xoa, Xoa, Rra, Rra, Ai^Qhu, Ai^Qhu, Ur, Aa, Rra, Chr, Chr, Ur, Aa, Aa, Aa, Ha^Dr, Aa, Aa, Ha^Qhh, Aa, Aa, Aa, Aa, Aa^Fdw, Aa^Fda
Ms, Ms, Ms, Ms^Xm, Ms^Xm, Ms, Ms, Ms, Ms, Ms, Ms, Ms, Ms, Ms, Xoa, Xoa, Xoa, Xoa, Urb, Urb, Xor, Xor, Xoa, Urb, Urb^Ii, Urb, Xoa, Xoa, Xoa, Urb, Urb, Xoa, Xoa, Xoa, Xoa, Xoa, Xoa, Aa, Rra, Xoa, Xoa, Aa, Chr, 1 Khr, Ch, Ur^Eb, Aa, Aa^Dr, Aa, Aa^Esa, Aa, Aa, Aa, Aa, Aa, Aa, Aa^Fda, Aa^Fda
Ms, Ms, Ms, Ms^Xm, Ms^Xm, Ms, Ms, Ms, Ms, Ms, Ms, Xoa, Xoa, Xoa, Xoa, Xoa, Xoa, Xoa, Urb, Urb, Xoa, Xoa, Urb^Dr, Xoa, Urb, Urb, Urb, Xoa, Xoa, Xoa, Urb, Urb, Xoa, Xoa, Xoa, Xoa, Xoa, Xoa, Rra, Xoa, Ur, Ur^Dr, Ha, Aa^Eb, Aa, Aa, Aa, Aa, Aa, Aa, Aa, Aa^Vka, Aa, Aa, Aa, Aa, Aa, Aa^Fda
Ms, Ms, Ms, Ms^Xm, Ms^Xm, Ms, Ms, Ms, Ms, Ms, Xoa, Xoa, Isa, Xoa, Isa, Ur, Urb, Urb, Xoa, Xoa, Xoa, Xoa, Urb, Urb, Urb, Urb, Xoa, Urb, Urb, Urb, Xoa, Urb^Dr, Isa, Isa, Xoa, Xoa, Ha, Ha, Ha, Rb^Vo, Re, Rb, Chr, Ha, Aa, Aa, Aa, Aa, Aa, Aa, Aa, Aa, Aa, Aa, Aa, Ha^Esa, Aa, Aa
Ms, Ms, Ms, Ms^Xm, Ms, Ms, Ms, Ms, Ms, Ms, Isa^Dr, Isa, Isa, Isa, Urc, Isa, Isa, Isa, Isa, Xoa, Xoi, Xoa, Xoa, Urb, Xoa, Xoa, Urb, Urb, Xoa, Xoa, Xoa, Isa, Isa, Isa, Aa^Dr, Xoa, Ha, Ha, Ha, Aa, Chr, Aa, Aa^Dr, Aa, Aa, Aa, Aa, Rb, Rb, Aa, Aa, Aa, Aa, Aa, Aa^Esa, Aa, Ha, Ha
Ms, Ms, Ms, Ms, Ms, Ms, Ms, Ms, Ms, Ms, Isa^Dr, Isa, Urc, Urc, Urc, Urc, Urc, Isa, Isa, Xoa, Xoi, Xoa, Xoa, Xoa, Urb, Urb, Urb, Urb^Dr, Isa, Xoa, Xoa, Xoa, Xoa, Xoa, Ha, Ha, Ha, Ha, Ha, Ha, Aa^Esa, Aa, Aa, Aa, Aa, Aa, Aa, Aa, Aa, Rb, Aa, Rb, Aa, Aa, Aa, Ha, Aa, Aa
Ms, Ms, Ms^Xm, Ms, Ms, Ms, Ms, Ms, Ms, Isa^Dr, Isa^Dr, Isa, Isa, Urc, Urc, Urc, Isa, Isa, Isa, Xoa, Xoa, Xoa, Urb, Urb, Xoa, Xoa, Isa, Isa^Dr, Isa, Isa, Xoa^Dr, Xoa, Xoa, Xoa, Ha, Ha, Ha, Ha, Ha^Qhh, Ha^Qhh, Aa, Aa, Aa, Aa, Aa^Voa, Aa, Aa, Aa, Aa, Aa, Aa, Rb, Aa, Aa, Aa, Aa, Aa, Ha^Esa
Ms^Xm, Ms, Ms^Xm, Ms, Ms, Ms, Ms, Ms, Ms, Ms, Ms, Isa^Dr, Isa, Isa, Isa, Isa, Isa, Isa, Aa, Xoa, Urb, Urb, Urb^Dr, Xoa, Isa, Xoa, Xoa, Isa, Xoa, Aa^Dr, Ha, Xoa, Ha, Ha, Ha, Ha, Ha^Fma, Ha^Qhh, Aa, Aa, Aa^Fdw, Aa, Aa, Aa, Aa, Aa, Aa, Aa, Aa, Rb, Rb, Aa, Aa, Aa^Vka, Aa, Aa^Esa, Ha, Ha
Ms, Ms^Xm, Ms^Xm, Ms^Xm, Ms^Xm, Ms, Ms, Ms, Ms, Ms, Ms, Xoa, Xoa, Isa, Xoa, Isa, Xoa, Aa, Aa, Aa, Isa^Dr, Xoa, Xoa, Isa, Isa, Isa, Xoa, Xoa, Ha, Ha, Ha, Ha, Ha, Ha, Ha^Qhh, Ha, Ha^Fma, Aa, Aa^Vka, Aa, Aa^Fda, Aa^Fda, Aa^Fda, Aa^Fda, Aa^Fdw, Aa, Aa^Fda, Aa, Aa, Aa, Rb, Aa, Aa, Aa, Ai^Qhu, Aa^Esa, Aa, Ha
Ms, Ms, Ms, Ms^Xm, Ms, Ms, Ms, Ms, Ms, Ms, Ms, Xoa, Ms, Xoa, Ms, Xoa, Urb^Dr, Aa, Ms, Isa^Dr, Aa, Aa, Xoa, Xoa, Xoa, Xoa, Xoa, Xoa, Ha, Ha, Ha, Ha, Ha^Qhh, Ha^Qhh, Ha^Esa, Ha^Fma, Aa, Aa^Fma, Aa^Fda, Aa, Aa^Fma, Aa^Fma, Aa, Aa^Fda, Aa^Fda, Aa^Esa, Aa^Fda, Aa, Aa, Rb, Rb, Aa, Aa, Ai^Qhu, Ai^Qhu, Ai^Qhu, Ai^Qhu, Ha
Ms, Ms, Ms, Ms, Ms, Ms, Ms, Ms, Ms, Ms, Ms, Ms, Ms, Ms, Ms, Ms, Ms, Ms, Ms, Ms, Ms, Isa^Dr, Xoa, Xoa, Xoa, Xoa, Qxu, Ha, Ha, Ha, Ha^Qhh, Ha^Qhh, Ha^Qhh, Ha, Ha^Qhh, Ha, Ha, Aa^Fma, Ha, Aa^Fda, Aa^Fda, Aa^Fma, Aa, Aa^Fda, Aa, Aa^Fda, Aa^Fda, Aa^Fda, Aa, Aa, Rb, Aa, Ai, Ai^Qhu, Ai^Qhu, Ai^Qhu, Ai^Qhu, Ai^Qhu
