Xu, Xu, Xu, Xu, Xu, Xu, Xu, Xu, Xu, Xu, Xu, Xu, Xu, Xu, Xu, Xu, Xu, Xu, Uu, Uu^Br|, Uu, Xu, Xu, Xu, Xu, Xu, Xu
Xu, Xu, Xu, Xu, Xu, Xu, Xu, Xu, Xu, Xu, Xu, Xu, Xu, Xu, Xu, Xu, Xu, Uh, Uu, Uu^Dr, Uu, Xu, Xu, Xu, Xu, Xu, Xu
Xu, Xu, Xu, Xu, Xu, Xu, Xu, Xu, Xu, Xu, Xu, Xu, Xu, Xu, Xu, Xu, Uu, Uu, Uu^Br/, Uu^Br|, Xu, Xu, Xu, Xu, Xu, Xu, Xu
Xu, Xu, Xu, Xu, Xu, Xu, Xu, Xu, Xu, Xu, Xu, Xu, Xuc, Xuc, Uu^Es, Uu^Dr, Uu^Br/, Uu^Br/, Uu^Es, Uu^Dr, Xu, Xu, Xu, Xu, Xu, Xu, Xu
Wog, Xu, Xu, Xu, Xuc, Xuc, Xuc, Xuc, Uu, Uh, Uu^Dr, Xu, Xuc, Uu, Uu, Uu^Br/, Uu^Dr, Uu, Uu, Xu, Xu, Xu, Xu, Xu, Xu, Xu, Xu
Wog, Wog, Xu, Xu, Xuc, Uu^Es, Uu^Es, Uu, Uu^Br/, Uu^Br/, Uu^Br\, Uu, Uu^Dr, Uu, Uu^Br/, Uu^Br|, Uu^Es, Uu^Es, Xu, Xu, Xu, Xu, Xu, Xu, Xu, Xu, Xu
Wog, Wog, Wog, Xu, Uu^Em, Ur^Em, Uu^Br/, Uu^Br/, Xu, Uu, Xu, Uu^Br\, Uu^Br\, Uu^Br/, Uu, Uu, Uu, Xuc, Xuc, Xu, Xu, Xu, Xu, Xu, Xu, Xu, Xu
Wog, Wog, Xu, Xu, Xu, Uu^Br|, Uu^Dr, Uu, Xu, Xu, Xu, Xu, Uu, Uu^Br\, Uu, Ur, Ur, Uu, Uu^Es, Xu, Xu, Xu, Xu, Xu, Xu, Xu, Xu
Wog, Wog, Wog, Xu, Xuc, Uu^Br|, Uu^Em, Xuc, Xu, Xu, Xuc, Xu, Uu, Uu^Br|, Uu, Ur, Uu^Es, Uu^Vu, Uu, Uh, Xu, Xu, Xu, Xu, Xu, Xu, Xu
Xu, Wog, Wog, Wog, Tb, Tb^Tf, Uu, Uu, Xu, Xuc, Ur, Xuc, Uu, Uu^Br|, Uu, Uu^Es, Uu, Uu, Tb^Tf, Xu, Xu, Xu, Xu, Xu, Xu, Xu, Xu
Xu, Wog, Tb, Tb, Tb, Uu^Br|, Uu, Uu, Uu, Uu^Vu, Ur^Es, Uu^Es, Uu^Br/, Uu^Br|, Ur, Xu, Xu, Tb^Tf, Tb^Tf, Xu, Xu, Xu, Xu, Xu, Xu, Xu, Xu
Xu, Xu, Tb, Tb^Tf, Qlf, Qlf^Br|, Qlf, Qlf, Qlf, Qlf, Uu^Tf, Uu^Es, Uu^Br|, Uu, Ur^Es, Xuc, Xuc, Xu, Xu, Xu, Xu, Xu, Xu, Xu, Xu, Xu, Xu
Xu, Xu, Xu, Qlf, Qlf, Uu^Vud, Qlf, Qlf, Uu^Em, Uu^Tf, Tb^Tf, Qlf, Qlf^Br|, Qlf, Qlf, Uu, Xuc, Xu, Xu, Xu, Uh, Xu, Xu, Xu, Xu, Xu, Xu
Xu, Xu, Xu, Tb^Tf, Ur^Dr, Qlf^Br|, Sm, Uu^Em, Uu^Em, 3 Uue, Uue, Uu, Rb^Br|, Uu^Edt, Ur^Edt, Qlf, Xuc, Xu, Xu, Uh, Uh, Xu, Xu, Xu, Xu, Xu, Uu
Xu, Xu, Xu, Xu, Xu, Ur^Br\, Ur^Br\, Wwf, Uu, Uue, Uu, Rb^Ecf, Rb^Br|, Uu^Edt, Qlf, Ur^Edt, Ur, Xuc, Xu, Uh, Uu, Xu, Xu, Xu, Uh, Uu, Wwf
Xu, Xu, Xu, Xu, Xu, Ur, Uu^Br|, Uu, Xu, Uh, Ur^Dr, Ur, Rb^Br|, Ur^Edt, Qlf, Qlf, Ur^Edt, Uh^Edt, Uu^Vud, Uu, Cud, Uu, Cud, Uh, Ur, Wwf, Wwf^Br/
Xu, Xu, Xu, Xu, Xu, Uu, Uu^Br|, Uu, Xuc, Xur, Uu, Xur, Xur, Uu^Br\, Uh^Br\, Uu^Edt, Uu^Br/, Wwf^Br/, Ur, Ur^Br\, Cud^Br\, 2 Kud, Wwf, Ur, Uu^Br/, Uu^Br/, Uu
Xu, Xu, Xu, Xu, Xu, Xu, Uu, Uu^Br\, Uu^Br\, Xuc, Uu, Uu, Xur, Xur, Xur, Uh^Br/, Xu, Xu, Xu, Uh, Ur, Wwf^Br\, Wwf^Br/, Wwf^Br/, Uu, Uu^Vu, Xu
Xu, Xu, Xu, Xu, Xu, Xu, Uh, Uu, Uu, Uu^Br\, Uu^Br|, Xur, Uu, Xur, Xu, Xu, Xu, Xu, Xu, Uu, Uu^Tf, Uu, Ur^Efs, Uu, Xu, Xu, Xu
Xu, Xu, Xu, Xu, Xu, Xu, Xu, Uu, Uu^Vu, Uh, Uu^Br|, Uu, Uu, Xu, Xu, Xu, Xu, Xu, Tb^Tf, Uu^Tf, Tb^Tf, Uu, Uu, Uu^Dr, Xu, Xu, Xu
Xu, Xu, Xu, Xu, Xu, Xu, Xu, Uu, Uu^Es, Uu, Uu^Br|, Uu, Xu, Xu, Xu, Xu, Xu, Xu, Xu, Tb^Tf, Tb^Tf, Uu^Tf, Uu, Uu, Xu, Xu, Xu
Xu, Xu, Xu, Xu, Xu, Xu, Xu, Uu^Es, Uu^Es, Rb^Es, Rb^Br|, Uh, Xu, Xu, Xu, Xu, Xu, Xu, Xu, Uh, Uh, Uu, Uu, Xu, Xu, Xu, Xu
Xu, Xu, Xu, Xu, Xu, Xu, Xu, Xu, Uh, Uu, Uu^Br|, Uu, Xu, Xu, Xu, Xu, Uh, Uh, Uu, Uu, Ur, Uu, Uu, Xu, Xu, Xu, Xu
Xu, Xu, Xu, Xu, Xu, Xu, Xu, Xu, Xu, Uu, Uu^Br|, Uu, Xuc, Xu, Xuc, Xu, Tb^Tf, Uu, Ur, Uu^Vu, Ur, Uu, Xu, Xu, Xu, Xu, Xu
Xu, Xu, Xu, Xu, Xu, Xu, Xu, Xu, Xuc, Uu, Uu^Br|, Uu, Uh, Xuc, Ur^Es, Uu, Ur, Ur, Uu, Ur, Uu, Uh, Xu, Xu, Xu, Xu, Xu
Xu, Xu, Xu, Xu, Xu, Xu, Xu, Xu, Uh, Ur, Rb^Br|, Uu, Uu, Ur^Es, Uu, Ur, Uu, Uu, Uu, Uu, Xu, Xu, Xu, Xu, Xu, Xu, Xu
Xu, Xu, Xu, Xu, Xu, Xu, Xu, Xu, Uu, Uu, Ur^Br|, Rb^Em, Uu, Uu, Uu, Uu, Xu, Xu, Xu, Xu, Xu, Xu, Xu, Xu, Xu, Xu, Xu
Xu, Xu, Xu, Xu, Xu, Xu, Xuc, Xuc, Rb^Br/, Rb^Br/, Uu, Uu^Es, Ur, Uu, Uu, Uu, Uu, Xu, Xu, Xu, Xu, Xu, Xu, Xu, Xu, Xu, Xu
Xu, Xu, Xu, Xu, Xu, Xuc, Cud, Cud, Cud, Uu, Uu, Ur, Uh, Uu, Uu, Xu, Uu, Xu, Xu, Xu, Xu, Xu, Xu, Xu, Xu, Xu, Xu
Xu, Xu, Xu, Xu, Uh, Uu, Cud, 1 Kud, Uu, Xuc, Xu, Xu, Xu, Uh, Uu, Uu, Xu, Xu, Xu, Xu, Xu, Xu, Xu, Xu, Xu, Xu, Xu
Xu, Xu, Xu, Xu, Uh, Uu, Uu, Rb^Br|, Uu, Xu, Xu, Xu, Xu, Xu, Xu, Xu, Xu, Xu, Xu, Xu, Xu, Xu, Xu, Xu, Xu, Xu, Xu
Xu, Xu, Xu, Xu, Xu, Uu, Uu, Rb^Br|, Uu, Xu, Xu, Xu, Xu, Xu, Xu, Xu, Xu, Xu, Xu, Xu, Xu, Xu, Xu, Xu, Xu, Xu, Xu
