Wot, Wot, Wot, Wot, Wot, Wot, Wot, Wot, Wot, Wot, Wot, Wwt, Wwt, Wot, Wwt, Wwt, Wwt, Ds, Ds, Ds, Ds, Gg, Hh, Hh, Ms, Gg, Ms^Xm, Ms, Ms, Ms, Ms, Ms^Xm, Ms^Xm, Ms^Xm, Ms^Xm, Ms^Xm, Ms^Xm, Ms, Ms^Xm, Ms^Xm, Ms^Xm, Ms^Xm, Ms^Xm, Ms^Xm, Ms^Xm, Ms^Xm, Ms^Xm, Ms^Xm, Ms, Ms, Ms^Xm, Ms, Ms, Ms, Ms^Xm, Ms, Ms^Xm, Ms, Ms, Ms, Ms, Ms^Xm, Ms^Xm, Ms^Xm, Ms^Xm, Ms^Xm, Ms^Xm, Ms^Xm, Ms^Xm, Ms^Xm, Ms^Xm, Ms^Xm, Ms^Xm, Ms, Ms, Ms, Ha, Ha, Ha, Aa, Aa, Wwg, Aa, Aa, Aa, Gg, Aa, Gll^Fp, Gll^Fp, Gll^Fp, Aa^Fpa, Aa^Fpa, Aa^Fpa, Aa^Fpa, Aa^Fpa, Gll^Fp, Aa^Fpa, Gll^Fp, Gll^Fp, Gll^Fp, Gg
Wot, Wot, Wwt, Wot, Wot, Wot, Wwr, Wot, Wot, Wot, Wot, Wot, Wwt, Wwt, Wwt, Wwt, Wwt, Wwt, Wwt^Wkf, Wwt^Wkf, Hh, Hh, Hh, Ms, Ms, Ms^Xm, Ms, Ms^Xm, Ms, Ms, Ms, Ms, Ms, Ms, Ms, Ms, Ms^Xm, Ms, Ms^Xm, Ms^Xm, Ms^Xm, Ms^Xm, Ms^Xm, Ms^Xm, Ms^Xm, Ms^Xm, Ms^Xm, Ms^Xm, Ms^Xm, Ms^Xm, Ms^Xm, Ms^Xm, Ms, Ms, Ms^Xm, Ms^Xm, Ms^Xm, Ms^Xm, Ms^Xm, Ms, Ms^Xm, Ms^Xm, Ms, Ms^Xm, Ms^Xm, Ms^Xm, Ms^Xm, Ms^Xm, Ms^Xm, Ms^Xm, Ms^Xm, Ms^Xm, Ms^Xm, Ms^Xm, Ms, Ms, Ha, Ha, Ha, Aa, Aa, Aa, Gg, Gg, Aa, Aa, Aa^Fpa, Aa^Fpa, Aa^Fpa, Aa^Fms, Gll^Fp, Aa^Fpa, Aa^Fpa, Aa^Fpa, Aa^Fpa, Aa^Fpa, Aa^Fpa, Aa^Fms, Gll^Fp, Gg, Aa
Wot, Wot, Wwt, Wwt, Wot, Wot, Wot, Wot, Wot, Wot, Wot, Wwt, Wot, Wwt, Ds, Ds, Wwt, Wwt, Ww^Vm, Wwt^Wkf, Hh, Mm, Ms, Ms, Ms, Ms, Ms, Ms, Ha^Fpa, Ha^Fpa, Ha^Fpa, Ha^Fma, Ms, Ms, Aa, Ms, Ms, Ms, Ms, Ms^Xm, Ms^Xm, Ms^Xm, Ms, Ms, Ms, Ms, Ms, Ms, Ms, Ms, Ms, Ms, Ms, Ms, Ms, Ms^Xm, Ms, Ms^Xm, Ms^Xm, Ms^Xm, Ms, Ms, Ms^Xm, Ms, Ms^Xm, Ms^Xm, Ms^Xm, Ms^Xm, Ms^Xm, Ms^Xm, Ms^Xm, Ms^Xm, Ms^Xm, Ms^Xm, Ms, Ms^Xm, Ms, Ms, Ha, Ha, Aa, Aa, Aa, Aa, Aa, Aa, Aa^Fpa, Aa^Fpa, Aa^Fpa, Gll^Fp, Gll^Fp, Aa^Fpa, Gll^Fp, Aa^Fpa, Gll^Fp, Gll^Fp, Gll^Fp, Gll^Fp, Aa^Fp, Aa, Aa
Wo, Wot, Wot, Wwt, Wwt, Wot, Wot, Wot, Wot, Wwt, Wwt, Wot, Wwt, Wwt, Ds, Ds, Ds, Wwt, Wwt^Ewf, Ds, Mm, Mm, Hh^Fp, Aa, Ha^Fpa, Ha^Fpa, Ha^Fpa, Ha^Fpa, Ha^Fma, Ha^Fpa, Ha^Fma, Ha^Fpa, Ha^Fma, Aa, Aa, Ms, Ms, Ms, Ms, Ms, Ms, Ha^Fpa, Ms, Ms, Ha^Fpa, Ms, Ha^Fpa, Ha^Fma, Ha^Fpa, Ms, Ms, Ms, Ms, Ha^Fpa, Ha^Fma, Ha^Fpa, Ms, Ms, Ms, Ms, Ms, Ms, Ms^Xm, Ms, Ms, Ms, Ms, Ms, Ms, Ms, Ms, Ms, Ms, Ms, Ms, Ms, Ms, Ms, Ms, Aa, Ha, Ha^Fpa, Aa, Aa, Gg, Aa, Gg, Aa^Fpa, Gll^Fp, Aa^Fpa, Gll^Fp, Aa^Fpa, Aa^Fpa, Aa^Fpa, Gll^Fp, Gll^Fp, Gll^Fp, Gll^Fp, Aa, Aa, Wwf
Wo, Wot, Wwt, Wwt, Wwt, Wwt, Wot, Wot, Wot, Wwt, Wot, Wot, Wot, Ds, Gs, Hh, Hh, Hh, Gs, Hh, Hh^Fp, Hh^Fp, Hh^Fds, Gg, Aa, Aa, Aa, Aa, Aa, Aa^Fpa, Aa, Aa, Ms, Ha^Fma, Aa, Aa, Aa, Ha^Fpa, Ha^Fpa, Ms, Ms, Ms, Ha^Fpa, Ha^Fpa, Ha^Voa, Ha^Fpa, Coa, Ha^Fma, Aa^Voa, Ha, Ha, Ha, Ha, Ha^Voa, Ha, Ha^Fma, Ha^Fma, Ms, Ms, Ms, Ms, Ms, Ms, Ms, Ms, Ms, Ms, Ms, Ms, Ms, Ms, Ms, Ms, Ms, Ms, Ms, Ms, Ms, Ms, Ms, Ms, Ms, Ha^Fpa, Ha^Fpa, Ha^Fpa, Ha^Fpa, Aa, Aa, Aa^Fpa, Gll^Fp, Gll^Fp, Gll^Fp, Aa^Fpa, Gll^Fp, Gll^Fp, Gll^Fp, Aa^Fp, Aa, Wwf, Wwf, Gg
Wo, Wo, Wot, Wwt, Wwt, Wwt, Wwt, Wot, Wot, Wot, Wwt, Wot, Dd^Esd, Gd, Dd, Gd, Gd, Gd, Gs, Hh, Gg, Gg, Hh^Fds, Gg, Aa, Aa, Aa, Aa, Aa, Aa, Aa, Aa, Ms, Ha^Fma, Ha^Fma, Ha^Fma, Ms, Ms, Ha^Fpa, Ha^Fpa, Ha^Fma, Ha^Fma, Ha^Fma, Aa^Fma, Coa, Koa, Coa, Coa, Aa, Aa, Aa, Aa, Aa, Aa, Aa^Voa, Aa, Aa^Voa, Ha^Fpa, Ha^Fpa, Ha^Fpa, Ha^Fpa, Ms, Ms, Ms, Ms, Ms, Ms, Ms, Ms, Ms, Ms, Ms, Ms, Ms, Ms, Ms, Ms, Ms, Uu^Vud, Ms, Ms, Ms, Ha^Fpa, Aa, Aa, Aa, Aa, Aa, Aa, Aa^Fpa, Gll^Fp, Gll^Fp, Gll^Fms, Gll^Fp, Gll^Fp, Gll^Fp, Gg, Gg, Wwf, Gg, Aa
Wo, Wo, Wot, Wot, Wwt, Wwrt, Wwrt, Wwt, Wot, Wwt, Wwt, Dd^Esd, Dd, Dd, Dd, Dd, Hd, Hd, Dd, Gs, Gg, Gs, Aa, Aa, Aa^Edt, Aa, Aa, Aa^Edt, Aa, Aa, Hh^Fmw, Ms, Ms, Ms, Ms, Ms^Xm, Ms, Md, Ms, Ha^Fma, Aa, Aa, Ha, Ha, Ai, Ai, Wwg, Ai, Aa, Aa, Aa, Aa, Aa, Aa, Aa, Aa, Ha^Fpa, Ha^Fpa, Ha, Ha^Fpa, Ha^Fpa, Ha^Fma, Ha^Fma, Ha^Fpa, Ha^Fpa, Ha^Fpa, Ms, Ha^Fpa, Ms, Ms, Ms, Ms, Ha, Ms, Ms, Ms, Ms, Ms, Kf, Ms, Ms, Ha^Fpa, Ha^Fpa, Ha^Fpa, Ha^Fpa, Ha^Fpa, Aa, Aa, Gg, Gg, Gll^Fp, Gll^Fp, Gs^Fms, Gll^Fp, Gll^Fp, Gs^Fms, Wwf, Wwg, Aa, Aa^Fma, Aa^Fma
Wo, Wo, Wo, Wot, Wwt, Wwrt, Wwt, Wwt, Wwt, Wwt, Wwt, Dd, Dd, Dd, Dd, Dd, Dd^Edt, Hd, Dd^Edt, Gd^Edt, Gd, Gs, Gs, Aa^Edt, Gg, Aa, Gg, Gs, Aa^Fds, Hh^Fms, Hh^Fmw, Ha^Fma, Ha^Fma, Ms, Ms, Ms, Ms^Xm, Mv, Md, Ha, Ha^Fpa, Aa, Ai, Ai, Ai, Wwg, Aa, Ai, Wwg, Aa, Wwg, Wwg, Ai, Wwg, Wwg, Aa, Ha^Fpa, Ha, Ha, Ha^Fpa, Ha^Fpa, Aa, Ha^Fpa, Ha^Fma, Ha^Fpa, Ha^Fpa, Ha^Fpa, Ha^Fpa, Ha^Fpa, Ms, Ha, Ha, Wwg, Ha, Ha^Esa, Ms, Ms, Uu^Vud, Uu, Ms, Ms, Ms, Ha^Fpa, Ha^Fpa, Ha^Fpa, Ha^Fpa, Ha, Ha, Gg, Gg, Gg, Gg, Gg, Gg, Wwf, Wwf, Gg, Aa^Fma, Aa^Fma, Aa^Fma, Aa^Fma
Wo, Wo, Ww, Ww, Ww, Wwrt, Wwt, Wwt, Wwt, Wwt, Wwt, Ds, Dd, Dd, Dd^Edt, Dd^Edt, Gd^Vo, Dd, Co, Dd, Dd, Gd^Vo, Gd^Vo, Gs^Edt, Gs, Gg, Aa, Gs, Aa, Aa, Aa, Aa, Ha^Fpa, Ha^Fpa, Ha^Fpa, Ms, Ms^Xm, Ms^Xm, Ms, Ms, Ha^Fpa, Aa, Ai, Wwg, Wwg, Ai, Aa, Aa, Wwg, Wwg, Aa, Aa, Aa, Aa, Aa, Wwg, Ai, Aa, Ai, Aa, Aa^Fma, Ha^Fpa, Ha^Fpa, Ha^Fpa, Ha, Aa, Ha, Ha, Ha^Fpa, Aa, Wwg, Wwg, Hh, Wwg, Wwg, Ms, Ha^Fpa, Ha, Aa^Esa, Ha^Fpa, Ha, Ms, Ha^Fma, Ha^Fpa, Ha^Fpa, Ha, Ha, Ha, Aa, Aa, Aa, Gg, Wwf, Wwg, Aa, Aa^Fma, Aa^Fp, Aa^Fma, Aa^Fma, Aa^Fpa, Gll^Fp
Wo, Wo, Wo, Wwr, Wwr, Wwt, Wwt, Wwrt, Wwt, Wwt, Wwt, Wwt, Dd, Dd, Dd, Dd, Gd, Dd, Gd^Vo, Ko, Co^Edt, Dd^Edt, Gd^Edt, Gs, Gg, Aa^Fmw, Gs^Fmw, Aa, Aa, Ha^Fpa, Aa, Aa, Aa, Ha^Fpa, Ms, Ms, Uu^Qhu, Ms, Ms^Xm, Ms, Ha^Fpa, Ms^Xm, Ms, Ai, Wwg, Wwg, Wwg, Wwg, Ha, Aa, Ha, Ha, Ms, Ha, Ha, Aa, Ha, Ai, Ai, Ai, Wwg, Ha^Fma, Aa, Aa, Aa, Ha^Fpa, Ha^Fpa, Ha, Wwg, Wwg, Aa, Aa, Ha, Ha, Hh, Wwg, Aa, Ha, Aa, Aa^Esa, Gg, Ha^Fma, Ha^Fpa, Ha^Fpa, Ha^Fpa, Ha^Fpa, Aa, Aa, Gg, Aa, Aa^Esa, Aa, Wwf, Aa^Fma, Aa^Fma, Aa^Fma, Gll^Fp, Gs^Fms, Gll^Fp, Aa^Fma, Aa^Fpa
Wo, Wo, Wo, Ww, Ww, Wot, Ww, Wwt, Wwt, Wwt, Wwt, Wwg^Bw\, Gd^Vo, Dd^Edt, Dd, Dd, Dd, Gd^Edt, Gd^Edt, Co^Dr, Gd, Gs, Gd, Gs^Edt, Gs^Edt, Gs^Fmw, Hh^Fms, Hh^Fms, Gs^Fmw, Aa, Ha^Fpa, Ha^Fpa, Ms, Uu, Uu^Qhu, Uu^Qhu, Ms^Xm, Uue^Qhu, Wwf^Qhu, Ms^Xm, Ms^Xm, Ms^Xm, Ms, Ms^Xm, Ms, Ms, Ms, Ha, Ha, Ms^Xm, Ms^Xm, Ms, Ms^Xm, Ms^Xm, Ms^Xm, Aa, Ms, Ha, Aa, Aa, Wwg, Aa, Aa, Aa, Aa, Aa^Fma, Aa^Fma, Aa, Wwg, Gs^Es, Hh, Ha, Ha, Ha, Aa, Wwg, Ai, Gg^Efm, Gg, Aa^Fpa, Aa^Fpa, Ha^Fpa, Ha^Fma, Ha^Fpa, Ha, Ha, Gg^Es, Gg^Es, Aa, Aa, Wwg, Wwg, Gg^Fms, Aa^Fma, Aa^Fma, Aa^Fma, Aa^Fpa, Gll^Fp, Aa^Fpa, Gll^Fms, Aa^Fpa
Wwg, Wo, Wo, Ww, Wo, Ww, Ww, Wwt, Wot, Wwt, Wwt, Wwt, Ds^Esd, Gd, Dd, Dd, Dd^Edt, Dd, Dd^Edt, Gd^Edt, Gd, Gd, Aa, Gs, Gs, Gg, Gs^Fmw, Gs^Fmw, Gs^Fmw, Ha^Fma, Ha^Fma, Ha^Fpa, Ha^Fpa, Ms, Ha^Fpa, Ms, Ms^Xm, Ms^Xm, Ms^Xm, Wwf^Qhu, Chw^Qhu, Ms^Xm, Ms^Xm, Ms, Ms^Xm, Ms^Xm, Ms^Xm, Ms^Xm, Ms^Xm, Ms^Xm, Ms^Xm, Ms^Xm, Ms^Xm, Ms, Rp, Rp, Ha^Dr, Ha, Ha, Aa, Ha, Wwg, Wwg, Wwg, Wwg, Wwg, Wwg, Wwg, Hh, Hh, Hh, Hh, Hh^Es, Hh, Gs, Wwg, Ai, Ai, Ai, Gs^Fms, Ha^Fpa, Ha^Fpa, Ha^Qhhf, Ha^Qhhf, Ha^Fpa, Ha^Voa, Aa^Qhh, Aa, Aa, Aa^Esa, Wwg, Gg, Aa^Fma, Gll^Fms, Gll^Fms, Aa^Fma, Aa^Fpa, Aa^Fpa, Aa^Fpa, Aa^Fpa, Aa^Fpa
Wwg, Wog, Wog, Wo, Wwr, Ww, Wo, Wo, Wot, Wot, Wwt, Wwt^Wkf, Wwt^Wkf, Ds, Dd, Dd^Edt, Gd, Dd, Aa, Dd, Gs, Gs, Gg^Edt, Aa, Aa, Gg, Gg, Gg, Aa, Aa^Fmw, Ha^Fma, Ha^Fpa, Ha^Fpa, Ms, Ms, Ms^Xm, Ms^Xm, Ms^Xm, Urb^Qhu, Wwf^Qhu, Uue^Qhu, 3 Uh^Qhu, Ha^Dr, Ms^Xm, Wwf^Qhu, Ai, Urb^Dr, Urb, Urb^Qhu, Ms^Xm, Aa, Ms^Xm, Ql^Bcx/, 2 Kfr, Cfr, Ms, Ha, Ms, Ms, Ms, Ms, Ha, Ha^Voa, Aa, Aa, Aa, Ha^Esa, Aa, Ha, Ha, Ms, Ha, Ha, Hh, Ha, Hh^Fds, Hh^Es, Hh^Es, Wwf, Wwf, Ha^Qhh, Ha^Qhh, Ha^_mh, Ha^Fpa, Ha, Aa, Gg, Aa^Qhh, Aa^Qhh, Aa^Qhh, Wwg, Aa^Fpa, Aa^Fpa, Gll^Fms, Aa^Fpa, Aa^Fpa, Aa^Fpa, Aa^Fpa, Aa^Fpa, Aa^Fpa, Aa^Fpa
Wog, Wog, Wwg, Wwg, Wwg, Ww, Wo, Wo, Wot, Wwt, Wot, Wwt, Wwt^Wkf, Wwt^Wkf, Wot, Dd^Esd, Gd, Gd, Gs, Aa, Aa, Gs, Aa, Aa^Fma, Aa^Fma, Aa^Fma, Aa^Fma, Aa^Fma, Ha^Fma, Ha^Fma, Ha^Fpa, Ha^Fpa, Ha^Fma, Ms, Ms, Ms, Ms, Ha^Dr, Uu^Qhu, Urb^Qhu, Ms^Xm, Urb^Qhu, Uu^Qhu, Uu^Qhu, Ms^Xm, Wwf^Qhu, Urb, Ch, Ms^Xm, Urb^Qhu, Urb^Qhu, Ql^Bcx/, Ql, Ms^Vud, Ms^Xm, Ms^Vud, Ms^Xm, Ms, Ms, Ms, Ms, Ha, Ha, Ha, Ms, Ha, Ha^Esa, Ha, Ms, Ha, Coa, Ms, Ha, Ha, Ha, Hh, Hh, Hh^Es, Aa, Wwf, Wwg, Ha^Qhh, Ms^Qhh, Ms^Qhh, Ms^Qhh, Hh, Hh^Qhh, Aa, Aa^Esa, Aa^Qhh, Wwg, Gg, Gll^Fms, Aa, Aa, Aa, Aa^Fpa, Aa^Fpa, Aa^Fpa, Aa^Fpa, Aa^Fpa
Wog, Wog, Wwrg, Wwg, Wog, Wog, Wo, Wo, Wo, Wot, Wot, Wot, Wot, Wot, Wot, Ds^Esd, Gs, Gd, Gd, Aa, Aa, Aa, Aa, Aa, Aa, Gs^Fmw, Ha^Fma, Ha^Fma, Ha^Fpa, Ha^Fpa, Ha^Fpa, Ha^Fpa, Ha^Fma, Ha^Fma, Ha^Fma, Ms, Ms, Uu, Ha^Fpa, Ms^Xm, Ms^Xm, Uu^Dr, Ms^Xm, Ms^Xm, Ms, Ms, Uu^Qhu, Ms^Xm, Uu^Qhu, Uu^Qhu, Uu^Qhu, Ms^Xm, Uue^Qhu, Mv^Qhu, Ms^Xm, Ms^Xm, Ms^Xm, Ms^Xm, Ms, Ms, Ms, Ha^Fma, Ms, Ms^Xm, Ms^Xm, Ms, Ha, Ms, Ha^Voa, Ha, Aa, Ha, Ms, Ms, Ha, Ha, Hh, Hh, Aa, Ha, Wwf, Ha^Qhh, Wwf, Wwt, Wwg, Ha^Qhh, Wwg, Gg^Qhh, Gg^Qhh, Aa^Qhh, Aa^Fpa, Wwg, Wwg, Aa^Esa, Aa, Gll, Gll^Fms, Aa^Fpa, Gll^Fms, Gll^Fms, Gll^Fms
Wog, Wwrg, Wwg, Wwg, Wog, Wog, Wo, Wo, Wo, Wo, Wo, Wot, Wo, Wot, Ww, Ww, Ds, Gd, Gd, Gs, Gd, Gs, Aa, Aa, Aa^Fma, Aa, Ha^Fpa, Ha^Fpa, Hh^Fp, Hh^Fp, Hh^Fp, Hh^Fp, Ha^Fma, Ha^Fpa, Ha^Fpa, Ha^Fpa, Ha^Fpa, Aa, Aa, Cfa, Aa, Ms, Ms, Ms, Ms, Ha^Dr, Ms^Xm, Uu^Qhu, Ms, Ms^Xm, Ms^Xm, Uue^Qhu, Ms^Xm, Uu^Qhu, Uue^Qhu, Uu, Uu, Ms, Ms^Xm, Ms, Ms, Ms, Uu, Ms, Aa^Voa, Ha, Ha, Ha, Ha, Aa^Esa, Aa, Ha, Ha^Voa, Ha, Ms, Ha, Gg, Gg^Efm, Aa, Aa, Aa, Wwf, Hh^Qhh, Hh^Qhh, Hh^Qhh, Wwg, Gg^Qhh, Wwg, Wwg, Aa, Aa^Esa, Aa^Esa, Wwg, Aa, Aa, Aa^Esa, Gg^Efm, Gll^Fms, Gll^Fms, Gll^Fms, Gll^Fms
Wwg, Wwg, Wwg, Wog, Wwg, Wog, Wog, Wo, Wo, Wo, Wo, Wo, Wo, Wo, Ww, Ww, Ww, Ds, Ds^Esd, Gd, Gd, Aa, Gg, Aa, Gg, Gg, Gs^Fp, Ha^Fpa, Aa^Fpa, Hh^Fp, Ha^Fpa, Ha^Fpa, Ha^Fpa, Ha^Fpa, Ha^Fpa, Ha^Fpa, Ha^Fpa, Ha^Fpa, Ha^Fpa, Aa, Ha^Fma, Ha^Fma, Hh^Fp, Ms, Ha^Fma, Ha^Fma, Ms, Uu^Qhu, Uu, Ms, Chr, Ms^Xm, Ms^Xm, Ms, Ms^Xm, Mv, Ms^Xm, Ms^Xm, Ms^Xm, Ha^Fma, Ms, Ms, Ha^Fma, Uue, Aa, Ms, Mm, Mm, Mm, Aa, Aa, Ms, Aa, Ha, Ha^Esa, Ha, Aa, Ha, Ha^Esa, Ha, Ha, Ha^Qhh, Hh^Fms, Hh^_mh, Hh, Gg^Qhh, Aa, Aa^Qhh, Aa^Qhh, Wwg, Gll^Fp, Gg, Wwg, Gs^Fms, Gll^Fp, Gs^Fms, Aa^Fpa, Gll^Fms, Gs^Fms, Aa^Fpa, Aa^Fpa
Wwg, Wwg, Wog, Wog, Wog, Wog, Wog, Wog, Wo, Wo, Wo, Wo, Wo, Wo, Ww, Ww, Ww^Wkf, Ds, Ds, Gd, Ss, Gs, Gg, Gg, Gg, Gg, Aa, Aa^Fpa, Gg, Aa, Aa, Aa^Fpa, Aa^Fpa, Aa^Fpa, Aa^Fpa, Aa^Fpa, Aa^Fpa, Ha^Fpa, Ha^Fpa, Aa, Aa, Hh^Fp, Hh^Fp, Ha^Fpa, Ha^Fpa, Ha^Fma, Ha^Fpa, Chr^Dr, Hhd^Vo, Aa, Ha^Fpa, Ha^Dr, Ms, Ms^Xm, Ms, Ms, Ms, Ms^Xm, Ms, Ha, Ha, Ha^Fma, Ms, Ms^Xm, Ha^Es, Aa, Hh, Hh, Hh, Ha, Ha, Aa^Esa, Gs, Ha, Aa, Aa^Esa, Ha, Hh^Fms, Ha, Ha^Voa, Hh, Ha^Qhh, Hh^Qhh, Ha^Qhh, Ha^Qhh, Aa, Aa^Qhh, Aa^Esa, Aa, Ai^Qhh, Ai, Gll^Fp, Wwg, Gg, Gll^Fp, Aa^Fpa, Aa^Fpa, Gll^Fms, Aa^Fpa, Gg, Aa^Fpa
Wwrg, Wwrg, Wwg, Wog, Wog, Wwg, Wwg, Wog, Wo, Wo, Wo, Wo, Wo, Wo, Ww, Ds, Gs, Ww^Wkf, Ds, Re^Vhr, Ss, Ss, Gg, Gg, Gg, Gll^Fp, Gll^Fp, Gll^Efm, Gll^Fp, Gs^Fp, Gs^Fp, Gs^Efm, Aa^Fpa, Aa^Fpa, Aa^Fpa, Aa^Fpa, Aa^Fpa, Gll^Fp, Gll^Fp, Ha^Fma, Aa^Fpa, Aa, Ha^Fma, Ha^Fma, Ha^Voa, Ha^Fpa, Ha^Fpa, Hhd^Vo, Gd^Dr, Gd, Aa^Voa, Ms, Ha^Fma, Ha, Ha, Ms, Ha^Fma, Ha, Ha^Fma, Ha, Ha^Fma, Aa^Fma, Ha, Ha, Ha, Ai, Hh, Hh, Ss, Ss, Gs^Fms, Gs^Fms, Hh^Fms, Gs, Hh, Aa, Hh^Es, Hh, Ha, Mm, Mm, Gg, Ha^Fma, Ha, Hh, Gg^Qhh, Hh, Aa^Qhh, Aa^Qhh, Aa^Esa, Ai, Wwg, Aa^Fpa, Aa^Fpa, Aa^Esa, Gll^Fp, Gll^Fp, Gll^Fp, Gs^Fms, Aa^Fpa, Aa^Fpa
Wwrg, Wwrg, Wwrg, Wwg, Wog, Wog, Wog, Wog, Wo, Wo, Wo, Wo, Wo, Ww, Ww, Ds, Ww, Ww, Ww, Gd, Re, Re, Re^Vhr, Gg, Gll^Fp, Gll^Fp, Gll^Fp, Gll^Fp, Gll^Fp, Gll^Fp, Gll^Fp, Gll^Ve, Gll^Efm, Aa^Fpa, Gll^Efm, Aa, Gg, Aa^Fpa, Aa^Fpa, Aa, Aa, Gg, Gll^Fp, Ha^Fpa, Ha^Fma, Hh^Vo, Hh^Fp, Ha^Fpa, Hhd, Rb^Gvs, Rb^Gvs, Ha^Fpa, Ha^Voa, Ha^Voa, Ha^Fma, Gg, Gs^Fp, Gs^Fp, Gs^Fms, Ai, Ai, Ai, Ss, Ss, Sm^Qhux, Ai, Gs^Em, Ss, Gs, Ss, Ds, Ss, Sm^Qhux, Hh^Es, Gg, Gs, Gs, Ha, Ha, Ha, Coa, Ha^Voa, Ha, Hh, Hh^Fms, Hh, Gs, Hh, Ha, Ha, Wwg, Wwg, Gg, Aa, Gs, Gs^Fp, Gs, Gll, Gs^Fms, Aa^Fpa, Gll^Fms
Wwrg, Wwg, Wwg, Wwg, Wog, Wog, Wog, Wog, Wo, Wo, Wo, Wo, Ww, Ww, Ww, Ww, Ww, Ww, Ww, Ww, Rb, Gg, Gg, Gg, Gg, Gll^Efm, Gll^Fp, Gs^Fp, Gs^Fp, Gs^Fp, Gs, Gll^Em, Gll^Em, Gll^Em, Gll^Fp, Gll^Fp, Gll^Efm, Aa^Fpa, Gs^Efm, Aa, Gs^Fds, Gs^Fds, Gll^Fp, Ha^Fma, Ha^Fma, Hh^Fp, Gs^Fmw, Hhd, Aa, Rb, Rb^Gvs, Ha^Fpa, Ha^Fpa, Ha, Ha^Voa, Ai, Ai, Ai, Ai, Ss, Ds, Ai, Ds, Ss, Ai, Sm^Qhux, Ds, Ds, Ss, Ds, Ds, Sm^Qhux, Sm^Qhux, Ds, Gs, Gs^Es, Aa, Gs, Hh, Hh, Aa^Edt, Hh, Hh, Ha, Ha, Ha, Co^Edt, Ha, Ha^Esa, Ha, Hh, Wwg, Wwf^Qhh, Gg, Gg, Gg, Aa, Gs^Es, Gs^Fms, Gll^Fp, Gll^Fp
Wwg, Wwg, Wwrg, Wwrg, Wog, Wog, Wog, Wo, Wo, Wo, Wo, Wo, Wo, Ww, Ww, Wo, Ch, Ch, Isa, Wwg^Bsb/, Ww, Ww, Ww^Wkf, Gg, Gll^Efm, Gll^Fp, Gll^Fp, Gll^Ft, Gll^Ft, Cv, Gll^Fp, Gll^Fp, Gll^Fp, Gs^Ft, Gs^Ft, Gll^Efm, Gll^Efm, Gll^Em, Gll^Fp, Gg, Gg, Gll^Fp, Gll^Fp, Gs^Fmw, Aa, Aa, Gs, Aa^Dr, Aa, Gs, Gs^Fds, Hh^Fds, Aa, Ha^Fma, Ha^Fma, Ha, Gs, Ss, Gd^Em, Ss, Ss, Ds, Ss, Ss^Dr, Ai, Ai, Ds^Esd, Ds^Dr, Sm^Qhux, Ss, Ss, Gs^Em, Ds, Ds, Ds^Esd, Ds, Aa^Esa, Aa, Aa, Aa^Edt, Hh, Mm, Co^Edt, Ms, Ms, Hh, Hh, Ha, Ha, Hh, Wwg, Wwg, Wwg, Gg, Gg, Aa, Aa, Gs, Gll^Fp, Gll^Fms, Gs^Fms
Wwrg, Wwg, Wog, Wog, Wog, Wog, Wo, Wo, Wo, Wo, Ww, Wo, Wo, Ww, Ww, Ds, Rr^Vhc, Kh, Isa, Rr^Vhc, Rr, Ww, Ww, Ds, Ds, Gll^Fp, Gs^Fp, Gs^Fp, Gs^Fp, Gll^Efm, Gll^Fp, Gs^Ft, Cv, Gs^Ft, Cv, Gg^Ve, Gll^Fp, Gll^Fp, Gll^Fp, Gg, Gll^Fp, Gll^Fp, Gll^Fp, Gg, Gll^Fp, Gg, Gg, Gs, Gs, Gs, Gs, Gg^Dr, Gg, Gg, Gs^Fds, Gs, Ss, Gs, Gs, Gd, Ss, Ss, Ss, Sm^Qhux, Sm^Qhux, Wwf, Wwf, Wwr^Qhux, Ss, Sm^Qhux, Ss, Ss, Ds, Ds, Sm^Qhux, Ds, Ds, Aa, Gs, Aa^Voa, Hh^Edt, Hh, Co^Edt, Ko, Co^Edt, Hh, Hh^Vo, Hh, Ha^Fma, Gs, Wwf^Qhh, Wwg, Gg, Aa, Gg^Fds, Gg, Gg, Gll^Fp, Gll^Fp, Gll^Fp, Gll^Fp
Wwg, Wwg, Wwg, Wog, Wog, Wog, Wo, Wo, Wo, Ww, Wo, Wo, Ww, Wo, Wo, Wwg^Dr, Wwg^Bw/, Isa, Rr^Eb, Rr, Hh^Qhh, Wwg^Ewf, Ww, Ww, Ds, Ds, Gs^Em, Gs^Fms, Gll^Efm, Gll^Efm, Gll^Em, Gll^Efm, Cv, Kv, Gll^Fp, Gll^Fms, Gll^Fp, Gll^Fp, Gll, Gg, Gg, Gll^Efm, Gll^Efm, Gll, Gll^Fp, Gll^Fp, Gs, Gs, Gg, Gs, Gg, Aa, Gg, Gg, Gs, Gs, Gs, Ss, Gs, Gd, Ss, Gs, Ss, Ss, Sm^Qhux, Sm^Qhux, Sm^Qhux, Ss, Ss, Ss, Sm^Qhux, Ss, Ss^Dr, Ds, Wwr^Qhux, Ss, Ds^Esd, Ds, Ds, Gs^Edt, Aa, Gs^Edt, Gs^Edt, Hh^Edt, Hh^Vo, Hh^Edt, Hh^Edt, Aa, Ha, Ha, Ha, Wwg, Wwg, Gs, Gg^Fds, Gg^Fds, Hh, Hh, Gll, Gll^Fms, Gll^Fms
Wwg, Wwrg, Wwrg, Wog, Wog, Wo, Wo, Wo, Wo, Wo, Ww, Ww, Ds^Esd, Ww, Ww, Ww, Ww, Isa, Ww, Ch, Ww, Md^Qhh, Ww, Ww, Ww, Gll^Ft, Gll^Ft, Gll^Ve, Gll^Fp, Gs^Fp, Gs^Ft, Gll^Fp, Gll^Fp, Gll^Fp, Gs^Ft, Gll^Fp, Gll^Ft, Gs^Fds, Ww^Wkf, Gll^Fp, Ww, Wwf, Ww, Wo, Wo, Gs, Gs^Dr, Gg, Gg, Gg, Gg, Gg, Gg, Gg^Efm, Gg^Efm, Gs, Gg^Efm, Gs^Em, Gs^Efm, Gd, Gs, Ss, Ss, Ss, Ss, Sm^Qhux, Ss, Ss, Ss^Dr, Ss, Ss^Dr, Ss^Bw/r, Ss^Bw\r, Sm^Qhux, Ss, Ss, Gs, Aa, Aa, Aa, Aa, Aa^Edt, Hh, Hh^Edt, Gs, Hh, Gg, Hh^Es, Hh, Ha, Wwf, Wwg, Gg, Gs^Es, Gg, Gg^Fds, Gg, Gg, Gg^Es, Gll, Gg
Wog, Wwrg, Wwg, Wog, Wog, Wo, Wo, Wo, Wo, Wo, Ww, Ww, Ww, Ww, Ww, Ww, Ww, Wwg^Bsb|, Ww, Ww, Ww, Ww, Ww, Wo, Wo, Gg^Ft, Gg^Fp, Gg^Em, Gll^Ft, Gg^Fp, Gg^Ft, Gll^Fp, Gll^Ft, Gll^Ft, Wwt, Gll^Ft, Wo, Ww^Wkf, Ww, Ww, Ww, Ww, Hh, Wo, Ww, Wwf^Edt, Wwf, Gg, Gg, Gg, Co^Dr, Gg^Edt, Gg, Gg, Gg, Gg, Gs, Gg^Efm, Gs^Efm, Gs^Efm, Gs^Efm, Gs, Gd^Em, Ss, Ss, Sm^Qhux, Ss, Ss^Dr, Ss, Wwr^Qhux, Wwr^Qhux, Ss, Ss, Ss^Dr, Ss, Ss, Ss, Gs, Gs, Aa, Gs, Aa, Gs, Gs, Ha, Gs, Hh, Gg, Gg, Wwg, Wwf^Qhh, Wwf, Gg, Hh, Hh^Qhh, Hh, Gg^Fds, Hh, Hh^Fms, Hh, Gg
Wog, Wog, Wwg, Wwrg, Wo, Wo, Wo, Ww, Ww, Ww, Ww, Ww, Wo, Ww, Ds, Ch, Gs^Vh, Rrc, Rrc, Rp, Gs, Ww, Rb, Wo, Ww, Ww, Ww, Gll^Ft, Mm, Gll^Ft, Gg^Ft, Gll^Fp, Gll^Ft, Gll^Em, Gg^Fp, Wo^Wkf, Ww, Ww, Ww, Ww, Hh, Wwt, Hh, Hh, Gg, Ww, Wwf, Co^Edt, Gg^Edt, Gg^Edt, Wwf^Edt, Ww, Ww, Wo, Ww, Gg^Es, Gs^Efm, Gs, Gs^Efm, Gs^Efm, Gs^Efm, Gs, Gd, Ss, Ss, Ss, Ss, Ss, Ss, Sm^Qhux, Sm^Qhux, Ss, Ss, Ss, Gd^Em, Gd^Em, Ss, Ss, Ss, Gg, Gg, Gs, Hh, Aa, Ha, Ha, Hh, Gg, Wwg, Wwf^Qhh, Gg^Efm, Gg^Efm, Hh^Qhh, Hh^Qhh, Wwf, Gg^Qhhf, Hh^Qhh, Hh^Fms, Hh^Fms, Hh^Fms, Hh^Fp
Wog, Wwg, Wwrg, Ww, Wo, Wo, Wo, Wo, Ww, Ww, Wo, Wo, Ww, Wwt, Rb, Rb^Gvs, Rb^Gvs, Rb^Gvs, Rb^Gvs, Rrc, Rrc, Rb, Rb, Wwf, Wwf, Ww, Ww, Ww, Ww, Ww^Wkf, Ww, Gll^Ft, Ww, Gg^Fp, Ww, Ww^Wkf, Ww, Ww, Gg, Gg, Hh, Hh^Es, Hh^Es, Gg^Efm, Gg, Wwf, Wwf, Wwf, Ww, Wwf, Ww, Ww, Ww, Ww, Wwf, Ww, Ww, Ww, Wo, Gs, Ww, Gs, Gg, Ss, Gd, Gd^Em, Ss, Gd, Ss, Ss, Ss, Ss, Ss, Ds, Ss, Gg, Gs, Gg, Gg^Efm, Gg, Gg^Es, Gg, Hh, Hh, Hh, Hh, Gg, Gg, Wwf^Qhh, Wwg, Gg^Qhh, Gg^Qhh, Wwf, Wwf, Hh^Qhh, Wwf, Uh^Qhh, Hh, Hh^Qhhf, Hh^Fp, Hh
Wog, Wog, Wo, Ww, Ww, Wo, Wo, Wo, Wo, Ww, Wo, Ww, Gs, Gs, Rb, Rb^Gvs, Re^Gvs, Rb^Gvs, Re^Gvs, Rb^Gvs, Rrc, Rp, Rp, Rp, Gg, Ww, Ww, Ww, Ww, Ww, Ww, Ww, Ww, Ww, Ww, Ww, Ww, Wwf, Hh, Hh, Hh, Hh, Hh^Es, Hh^Es, Hh, Gg, Hh, Wwf, Wwf, Ww, Gg, Gg, Gg^Efm, Gg, Gg, Wwf, Ww, Ww, Ww, Ww, Ww, Ww, Ww, Gg, Ww, Gd, Ww, Ss, Gs, Gs, Ss, Gs, Gs, Gs, Gg, Gg, Gg^Efm, Gg^Efm, Gg^Efm, Gg, Gg, Gg, Gs, Gg, Gg^Efm, Gg^Efm, Gg, Wwf^Qhh, Wwg, Gg^Qhh, Wwf, Wwg, Hh^Qhh, Hh^Qhh, Hh^Qhh, Wwg, Wwg, Hh^Qhh, Wwf, Uh^Qhh, Hh^_mh
Wo, Wo, Ww, Ww, Wwr, Wo, Wo, Wo, Ww, Wo, Ww, Ww, Ds, Gs, Gs, Rb, Gs, Re^Gvs, Re^Gvs, Rb^Vwm, Rrc, Rb^Gvs, Gg^Gvs, Rp, Rp, Gg, Rp, Gs^Vh, Rp, Ww^Bw/, Rp, Ww, Wwf, Wwf, Wwf, Wwf, Gg, Gg, Gg, Hh, Gs^Es, Hh^Fms, Hh^Qhhf, Hh^Qhh, Gs^Em, Gs, Hh, Hh, Gg, Rb, Rb, Gg^Efm, Gg^Efm, Gg^Efm, Gg^Efm, Gg, Gs^Fms, Wwf, Wwf, Wwf, Wwf, Ww, Wwf, Ww, Ww, Ww, Ww, Ww, Ww, Gs^Em, Gs, Gg, Gg, Gg^Efm, Gg^Efm, Gg^Efm, Gg^Efm, Gg^Efm, Gg, Gg, Gg, Gg^Edt, Gg^Edt, Gg^Efm, Gg^Efm, Gg^Efm, Wwf, Wwf, Wwg^Qhh, Wwf, Gs^Qhh, Gs^Qhh, Hh^Fms, Hh, Hh, Hh^Qhh, Hh^Qhh, Wwf, Uh^Qhh, Uh^Qhh, Hh^Fp
Wwr, Wwr, Ds, Hd, Hd, Ww, Ww, Ww, Ww, Ww, Ww, Ww, Ww, Ds, Gs, Gs, Gd^Dr, Gs, Gd^Edb, Re^Gvs, Rrc, Re^Gvs, Gg, Rp, Gg, Rp, Gg, Rr, Rp, Rp^Ecf, Rp, Rp, Gs^Fmw, Gg, Gs^Fmw, Gg, Gg, Gs, Rp, Rp, Rr^Vhc, Gd^Qhh, Gd^Es, Gs^Qhh, Mm^Qhh, Hh^Qhh, Mm^Qhh, Hh, Hh^Fds, Gg, Gg, Gg, Gg, Gg, Gg^Fms, Gg^Fds, Gg^Fds, Gg, Gg^Fds, Gg, Gg, Gg, Gs, Gs, Gg, Gg, Gg, Ww, Ww, Ww, Ww, Ww, Ww, Gg, Gg^Efm, Gg^Efm, Gs, Gs^Efm, Gs^Edt, Gd^Dr, Gs, Gd, Gd^Dr, Gg^Efm, Gg, Gg, Wwg, Wwg^Qhh, Gg, Hh^Qhh, Hh, Hh, Hh, Hh, Hh^Fms, Hh, Hh^Fp, Hh^Qhh, Hh^Fms, Hh^Fp, Hh^Fp
Wo, Wwr, Gd, Mv, Gll^Ftr, Wwf, Ww, Ww, Wo, Wo, Wo, Ww, Ww, Ww, Ds, Gs, Gd, Chr^Dr, Gd, Gd^Dr, Rrc, Gs, Rp, Rp, Gg, Gg^Es, Gs^Fmw, Gs^Fp, Gs^Fdw, Gs, Gs^Fdw, Gs^Fmw, Gs^Fp, Gs^Fmw, Gs^Efm, Gg^Efm, Gg^Es, Hh, Hhd, Rp^Eb, Hhd^Qhh, Md^Qhh, Md^_mh, Md^Xm, Md^Xm, Mm^Qhh, Mm^Qhh, Hh^Fds, Hh^Es, Gg, Gg, Rb, Gg, Gg, Gs^Fp, Gg^Fds, Gg^Fds, Gs^Fms, Gs^Fms, Gg^Fds, Gg, Gg, Gs^Fms, Gg^Fds, Gg, Gs, Gs, Gg, Gs, Ww, Gg, Ww, Ww, Ww, Ww, Gg, Gs, Gs^Edt, Gs, Gd^Edt, Gd, Gd^Dr, Gs^Edt, Gs, Wwf, Wwg, Wwg, Wwg, Gg^Efm, Gg, Hh, Hh, Hh, Hh, Hh^Fms, Hh^Fp, Hh, Hh^Fms, Hh, Hh, Hh^Fms
Ww, Wog, Wog, Gs^Edb, Gd^Edb, Gd^Vhr, Ww, Ww, Ww, Wo, Wo, Ww, Ww, Ds, Re, Re, Re^Gvs, Gd^Dr, Gd, Chr^Edb, Rrc, Gs, Gg, Gs^Fdw, Gs^Fdw, Gs^Fmw, Gs^Fdw, Gs^Fdw, Gs^Fdw, Gs^Fp, Gs^Fms, Gs^Fp, Gs^Fdw, Gg^Efm, Gs^Efm, Gg, Hh^Es, Hh^Es, Hhd, Md^Qhh, Hhd^Es, Md^Qhh, Md^Xm, Md^Xm, Md^Xm, Md^Xm, Mm^Qhh, Mm, Hh, Hh^Fds, Rb, Re, Gg, Gg^Fds, Gg^Fds, Gs^Fms, Gg^Fds, Gg^Fds, Gs^Fms, Gg^Fds, Gs^Fms, Gs^Fms, Gg^Fds, Gg^Fds, Gg, Gs, Gs, Gs, Gs, Gg, Gs, Gg, Gg, Ww, Ww, Ww, Ww, Gs, Gs, Gs, Gs^Edt, Gd, Wwf, Wwf, Wwg, Wwg, Gg, Gg^Efm, Gg^Fms, Hh^Fms, Hh, Hh^Fms, Hh^Es, Hh^Es, Hh, Hh, Hh, Hh, Hh^Fp, Hh^Fms, Hh^Fms
Gll^Ftr, Wwr, Ww, Gll^Ftr, Ww, Ww, Ww, Ww^Edb, Ww, Wo, Ww, Ww, Ww, Ds^Esd, Rb, Rb^Gvs, Rb^Gvs, Rb^Gvs, Rb, Gd^Dr, Rrc, Gs, Gs^Fmw, Gs^Fmw, Gs^Fp, Gs^Fmw, Gs^Fp, Gs^Fp, Gs^Fmw, Gs^Fp, Gs^Fp, Gs^Fp, Gg^Efm, Gs^Efm, Gs, Gg, Hh^Es, Hh^Es, Md, Hhd^Es, Hh^Es, Hh^Qhh, Mm^Qhh, Mm^Qhh, Mm^Qhh, Gs^Qhh, Gs, Hh^Es, Gg, Gg, Rb, Gg, Gg^Fms, Gg^Fms, Gs^Fms, Gg^Fds, Gg^Fds, Gs^Fms, Gs^Fms, Gs^Fms, Gg, Gs, Gs^Fms, Gs^Fms, Gs, Gs, Gs^Efm, Gs^Efm, Gs^Efm, Gs, Gs, Gg, Gs, Gg, Gs, Ww, Ww, Ww, Wwf, Wwf, Ww, Gs^Edt, Wwf, Wwg, Gs, Gs, Gg, Gg^Fms, Gg^Efm, Gg^Es, Gg^Efm, Gg, Hh, Hh, Hh, Gg^Fp, Hh, Hh, Hh^Es, Hh^Fp, Hh
Gll^Ftr, Wwt, Ww, Ww, Wwt, Wwt, Wwr, Ww, Wo, Wo, Wo, Wwt, Ww, Gd, Gd^Edb, Rb^Edb, Gd, Rb^Gvs, Rb^Gvs, Gs, Rrc, Gg, Gg, Gs^Fmw, Gs^Fp, Gs^Fp, Gs^Fms, Gs^Fmw, Gs^Fmw, Gs^Fp, Gs^Fp, Gg^Es, Gs^Fmw, Gs, Gs, Hh, Hh, Md, Hh, Hh^Es, Gs, Hh, Mm, Mm, Hh, Hh^Fds, Gg, Gg, Gg, Re, Isa^Vhc, Ch, Isa^Ebn, Gg, Gg^Fds, Gg^Fds, Gs^Fms, Gg^Fds, Gg, Gg^Es, Gg, Gg, Gs, Gg, Gs, Gs^Efm, Gs, Gs^Efm, Gs^Efm, Gs^Efm, Gs, Gs, Gs, Gg, Gs^Es, Ww, Ww^Ewf, Gs, Re, Wwf, Wwf, Wwf, Ww, Ww, Ww, Ww, Wwf, Gg^Efm, Gg, Gg^Efm, Gg, Hh, Wwf, Gg, Hh, Hh, Hh, Hh, Wwf, Gg, Wwg
Gs^Edb, Wwt, Ww, Ww, Ww, Ww, Ww, Wo, Wo, Ww, Ww, Ww, Gd, Gd, Gd, Gd, Chr, Gd, Gg, Gs, Gg, Rrc, Gg, Gg, Gs^Fdw, Gs^Fdw, Gs^Fp, Gs^Fp, Gs^Fp, Gs^Fp, Gs^Fmw, Gs^Fmw, Gs^Fmw, Gs, Gs, Gd, Hhd, Hhd, Hhd^Es, Hhd, Gs^Es, Hh^Es, Hh, Hh, Hh, Hh, Gg, Gg, Gs, Gg, Rrc, Isa^Vhc, Rrc, Isa, Gg, Gg, Gg, Gg, Gs, Gs, Gs, Gs, Gs, Gs, Gs, Gs, Rrc, Gs, Rrc, Gs, Gs, Gs, Gs, Gg, Gg, Ww, Ww, Gg, Rb, Re, Gg, Gg, Gg, Gg, Gs, Ww, Gs, Wwf, Ww, Ww, Ww, Ww, Gs, Wwf, Ww, Ww, Wwf, Wwf, Gs, Wwf, Gs
Wo, Ww, Wo, Ww, Wo, Ww, Ww, Ww, Wo, Ww, Wwg^Edb, Gll, Gd, Gd, Gs^Edb, Gs, Ds, Gs^Edb, Wwt, Gs^Vc, Re, Rrc, Rrc, Gg, Gg, Gs^Fmw, Gs^Fdw, Gs^Fp, Gs^Fp, Gs^Fmw, Gg^Fp, Gs^Fmw, Gs^Fmw, Gs^Fmw, Gs, Gd, Gd, Gd, Hhd, Gd, Gg^Fms, Gg, Gg, Gg, Gg, Gg, Gg, Gg, Gs, Rp, Rrc, Gs, Gs, Rrc, Rrc, Rrc, Rrc, Gg, Rrc, Gs, Gs, Gs, Rrc, Rrc, Rrc, Rrc, Gs, Rrc, Hh, Rrc, Rrc, Rb, Rp, Gg, Rb, Wwf, Wwf, Rb, Rb^Gvs, Rb, Gg, Hh, Hh, Hh, Hh, Hh, Gg, Gs, Hh, Gs, Gs, Gs, Gd, Gs, Gd, Gd, Gd, Gs, Gd, Gd, Gd
Wo, Wo, Wo, Wo, Wo, Ww, Ww, Ww, Wwr, Ww, Wwt, Ds, Ds, Gll, Ds, Wwt, Wwt, Wwt, Wwt, Wwt^Bw/, Ds, Re, Rp, Rrc, Rrc, Gg, Gs^Fdw, Gg, Gg, Gg, Gg, Gg^Fp, Hh^Fms, Hh, Hh^Es, Hh, Hh, Gd, Gs, Gs, Gg^Fp, Gs^Fp, Gg, Gg, Gg, Gs, Gs^Edt, Gs, Gs^Edt, Rp^Edt, Rrc, Rp, Re^Gvs, Re, Re, Gg, Gg, Rrc, Gs, Rrc, Rrc, Rrc, Gs, Gs, Gs, Gs, Gs, Gs, Hh^Es, Hh, Gg, Rrc, Rrc, Rp, Re, Re, Wwf, Rb^Gvs, Rb^Gvs, Rb^Gvs, Rb^Gvs, Gg^Es, Hh^Es, Gg, Hh, Hh, Hh, Hh, Hh, Gd, Gd, Gd, Gd, Gs, Gd, Hhd, Hhd, Hhd, Hhd, Hhd, Hhd
Wog, Wo, Wo, Wo, Ww, Wo, Wo, Ww, Ww, Ww, Ww, Wwt, Ds, Ds^Edb, Ww, Wwt, Wwt, Ww, Wwt, Wwt, Ds, Gg, Rp, Rp, Gg, Rrc, Rrc, Gg, Gg, Gg, Hh, Gg^Fp, Gs^Fms, Gg, Hh, Hh^Es, Hh, Gs^Es, Hh^Es, Gs, Gg, Gs, Hh, Gs, Gs, Gs^Edt, Isa, Isa, Isa^Edt, Isa, Ch^Edt, Rp^Edt, Re^Gvs, Re^Gvs, Re, Gg, Gg, Rrc, Gs^Efm, Gs^Efm, Gs^Efm, Gs, Gs, Gs, Gs, Gs, Gs, Gs, Gs, Gs, Gs, Gs^Efm, Gs, Ch, Wwf, Ww, Rb^Gvs, Rb^Gvs, Rb^Gvs, Rb^Gvs, Gg, Hh, Hh, Hh, Hh, Hh, Hh, Hh, Gs, Gs, Gs, Gd, Gs, Gd, Gs, Gd, Hhd, Hhd, Hhd, Hhd, Hhd
Wog, Wog, Wo, Wo, Ww, Wo, Wo, Wo, Ww, Ww, Ww, Wwt, Wwt, Wwt^Edb, Wwt, Ww, Wwt, Wwt, Ds, Ds, Gg, Gg, Rp, Gg, Gg, Gg, Gg, Rrc, Rrc, Gg, Gg, Hh, Hh, Hh, Hh, Hh^Es, Hh^Es, Hh, Hh, Hh, Gs, Hh, Hh, Gs, Rp^Edt, Isa^Ebn, Isa^Edt, Isa^Vhc, Isa, Kh, Ch^Edt, Rp, Rp, Rb^Gvs, Rb, Re, Gg, Rrc, Rrc, Gs^Efm, Gs^Efm, Gs^Efm, Gs^Efm, Gs, Gs^Efm, Gs^Efm, Gs, Gs, Gs, Gs, Gs, Gs^Efm, Gg^Efm, Wwf, Ww, Re^Gvs, Re, Re, Hh, Hh, Hh, Hh, Hh, Mm, Mm, Hh, Hh, Gg, Gg, Gs, Gg, Gs, Gs, Gs, Gd, Gd, Gd, Gd, Gd, Hhd, Hhd
Wog, Wog, Wo, Wo, Wo, Wo, Wo, Ww, Ww, Ww, Ww, Ww, Ww, Ww, Ww, Ww, Ds, Ds, Gs, Gg, Gg, Rp, Gg, Gg, Gg, Gg, Re, Gg, Gg, Rrc, Gg, Gs^Fms, Hh, Gg, Gg, Hh, Hh, Hh, Hh, Hh, Gs, Gd^Edt, Rrc, Gd^Edt, Rrc, Rrc, Ch^Edt, Isa^Edt, Isa, Isa^Ebn, Isa, Rp, Gs^Edt, Rb^Gvs, Rb^Gvs, Rb^Gvs, Rb^Gvs, Gs, Rrc, Gs, Gg, Gs, Gs, Gs, Gs, Gs, Gs, Gs, Gs^Es, Gs, Hh, Gs, Gg, Ww, Ww, Re, Gg^Es, Gg, Hh^Es, Hh, Hh, Hh, Ch, Mm, Hh, Hh, Gg, Gg, Gg, Gg, Gg, Gg, Gg, Gs, Gs, Gd, Gd, Gs, Hhd, Hhd, Hhd
Wog, Wo, Wo, Wo, Wo, Ww, Ww, Ww, Ww, Wo, Wo, Ww, Ww, Ww, Wwt, Ds, Gll, Gll, Rp, Rp, Gg, Gg, Re^Gvs, Gg, Rb^Gvs, Re^Gvs, Re^Gvs, Re, Re, Rrc, Rp, Gg, Gg, Hh, Hh, Hh, Hh, Hh, Hh, Gs, Rp, Rrc, Rp, Rrc, Gd, Gd, Gd, Rb, Rb, Isa, Gs, Rp^Edt, Rp^Edt, Rb, Rb^Gvs, Rb^Gvs, Re^Gvs, Rb, Rb, Rrc, Rb, Gg, Gg, Gs, Re, Gs, Hh, Gs, Hh, Hh, Hh, Hh, Gg^Es, Gg, Ww, Ww, Gg, Hh, Hh, Hh, Hh, Hh, Gs, Hh, Gg, Hh, Hh, Hh, Hh, Hh, Hh, Hh, Gg, Gg, Gs, Gg, Ss, Gd, Gd, Gd, Gd
