Ms, Ms, Ms, Ms, Ms, Ms, Ms, Ms, Ms, Ms, Ms, Ms, Ms, Ms, Ms, Ms, Ms, Ms, Ms, Ms, Ms, Ms, Ms, Ms, Ms, Ms, Ms, Ms, Ms, Ms, Ms, Ms, Ms, Ms, Ms, Ms, Ms, Ms, Ms, Ms, Ms, Ms, Ms, Ms, Ms, Ms
Ms, Ms, Ms, Ms, Ms, Ms, Ms, Ms, Ms, Ms, Ms, Ms, Ms, Ms, Ms, Ms, Ms, Ms, Ms, Ms, Ms, Ms, Ms, Ms, Ms, Ms, Ms, Ms, Ms, Ms, Ms, Ms, Ms, Ms, Ms, Ms, Ms, Ms, Ms, Ms, Ms, Ms, Ms, Ms, Ms, Ms
Ms, Ms, Ms, Ms, Ms, Ms, Ms, Ms, Ms, Ms, Ms, Ms, Ms, Ms, Ms, Ms, Ms, Ms, Ms, Ms, Ms, Ms, Ms, Ms, Ms, Ms, Ms, Ms, Ms, Ms, Ms, Ms, Ms, Ms, Ms, Ms, Ms, Ms, Ms, Ms, Ms, Ms, Ms, Ms, Ms, Ms
Ms, Ms, Ms, Ms, Ms, Ms, Ms, Ms, Ms, Ms, Ms, Ms, Ms, Ms, Rr^Vd, Ms, Ms, Ms, Ms, Ms, Ms, Ms, Ms, Ms, Ms, Ms, Ms, Ms, Ms, Ms, Ms, Ms, Ms, Ms, Ms, Ms, Ms, Ms, Ms, Ms, Ms, Ms, Ms, Ms, Ms, Ms
Ms, Ms, Ms, Ms, Ms, Ms, Ms, Ms, Aa^Vka, Ms, Ms, Ms, Ms, Ms, Rrc, Ms, Ms, Ms, Ms, Ms, Ms, Ms, Ms, Ms, Ms, Ms, Ms, Ms, Ms, Ms, Ms, Ms, Ms, Aa^Vka, Ms, Ms, Ms, Ms, Ms, Ms, Ms, Ms, Ms, Ms, Ms, Ms
Ms, Ms, Ms, Ms, Ms, Ms, Ms, Ms, Ms, Ms, Ms, Ms, Ms, Ms, Rrc, Ms, Ms, Ms, Ms, Ms, Ms, Ms, Ms, Ms, Ms, Ms, Ms, Ms, Gs, Rr^Vd, Ms, Ms, Ms, Ms, Ms, Ms, Ms, Ms, Ms, Ms, Ms, Ms, Ms, Ms, Ms, Ms
Ms, Ms, Ms, Ms, Ms, Ms, Ms, Ms, Ms, Ms, Ms, Ms, Ms, Rrc, Ms, Ms, Ms, Ms, Ms, Ms, Ms, Ms, Ms, Ms, Ms, Ms, Ms, Gs, Gs, Gs, Ms, Ms, Ms, Ms, Ms, Ms, Ms, Ms, Ms, Ms, Ms, Ms, Ms, Ms, Ms, Ms
Ms, Ms, Ms, Ms, Ms, Ms, Ms, Ms, Ms, Ms, Ms, Ms, Ms, Rrc, Rrc, Ms, Ms, Ms, Ms, Ms, Ms, Ms, Ms, Ms, Aa^Vka, Ms, Ms, Gs, Gs, Gs, Gs, Ms, Ms, Ms, Ms, Ms, Ms, Ms, Ms, Ms, Ms, Ms, Ms, Ms, Ms, Ms
Hh, Ms, Hh, Ms, Hh, Ms, Hh, Ms, Ms, Ms, Ms, Ms, Ms, Ms, Ms, Rrc, Ms, Ms, Ms, Ms, Ms, Ms, Ms, Ms, Ms, Ms, Ms, Ms, Ms, Gs, Gs, Gs, Ms, Ms, Ms, Ms, Ms, Ms, Ms, Ms, Ms, Ms, Ms, Ms, Ms, Ms
Hh, Hh, Hh, Hh, Hh, Hh, Hh, Hh, Hh, Hh, Hh, Ms, Hh, Ms, Gs, Rrc, Rrc, Hh, Hh, Hh, Hh, Ms, Hh, Hh, Hh, Hh, Hh, Ms, Hh, Gs, Hh, Hh, Hh, Hh, Hh, Ms, Hh, Ms, Hh, Ms, Hh, Ms, Hh, Ms, Ms, Ms
Hh, Hh, Hh, Hh, Hh, Hh, Rr^Vd, Hh, Hh, Hh, Hh, Hh, Gs, Gs, Hh, Hh, Rrc, Hh, Hh, Hh, Hh, Hh, Hh, Hh, Hh, Hh, Hh, Hh, Gs, Gs, Hh, Hh, Hh, Hh, Hh, Hh, Hh, Hh, Hh, Hh, Hh, Hh, Hh, Hh, Hh, Hh
Hh, Hh, Hh, Hh, Gs, Gs, Gs, Hh, Hh, Hh, Hh, Hh, Gs, Gs, Hh, Hh, Rrc, Hh, Rrc, Hh, Hh, Hh, Hh, Hh, Hh, Hh, Hh, Hh, Gs, Hh, Rrc, Hh, Hh, Hh, Hh, Hh, Hh, Hh, Hh, Hh, Hh, Hh, Hh, Hh, Hh, Hh
Hh, Hh, Hh, Gs, Gs, Gs, Gs, Hh, Hh, Hh, Hh, Hh, Gs, Hh, Hh, Hh, Rr^Vd, Rrc, Hh, Rrc, Rrc, Hh, Rrc, Rrc, Rrc, Rrc, Rrc, Rrc, Rrc, Rrc, Gs, Rrc, Rrc, Hh, Rrc, Hh, Hh, Hh, Hh, Hh, Hh, Hh, Hh, Hh, Hh, Hh
Hh, Hh, Hh, Hh, Hh, Hh, Hh, Hh, Hh, Hh, Gs, Gs, Gs, Gs, Gs, Gs, Hh, Hh, Hh, Hh, Hh, Rrc, Hh, Hh, Hh, Hh, Hh, Gs, Hh, Rrc, Hh, Gs, Gs, Rrc, Gs, Rrc, Rrc, Rrc, Rrc, Rrc, Rrc, Gs, Rrc, Hh, Hh, Hh
Hh, Hh, Hh, Hh, Hh, Hh, Hh, Hh, Hh, Gs, Hh, Hh, Hh, Hh, Hh, Hh, Hh, Hh, Hh, Hh, Hh, Hh, Hh, Hh, Hh, Hh, Hh, Hh, Hh, Rrc, Hh, Hh, Hh, Gs, Gs, Hh, Hh, Hh, Ds, Ds^Ewsh, Ds, Rr^Vd, Ds, Rrc, Rrc, Rrc
Gs, Gs, Gs, Gs, Gs, Gs, Gs, Gs, Gs, Gs, Gs, Hh, Hh, Hh, Gs, Hh, Hh, Hh, Gs, Hh, Hh, Hh, Gs, Hh, Hh, Hh, Gs, Hh, Gs, Rrc, Gs, Gs, Gs, Gs, Gs, Gs, Ds, Ds, Wwf, Wwf, Wwf, Wwf, Wwf, Ds, Ds, Gs
Gs, Gs, Gs, Gs, Gs, Gs, Gs, Gs, Gs, Gs, Gs, Gs, Gs, Rr^Vd, Gs, Gs, Gs, Gs, Gs, Gs, Gs, Gs, Gs, Gs, Gs, Gs, Gs, Gs, Rrc, Rrc, Gs, Gs, Gs, Gs^Efm, Ds, Ds, Wwf, Wwf, Wwf, Ww^Ewl, Wwf, Wwf, Ww^Ewl, Wwf, Wwf, Ds
Gs, Gs, Gs, Re^Vct, Ce, Re^Vct, Gs, Gs, Gs, Gs, Gs, Gs, Ds, Ds, Ds, Ds, Ds, Gs^Efm, Gs, Gs, Gs, Ds, Ds^Ewsh, Ds, Ds, Gs, Gs, Rrc, Gs, Gs, Ds, Ds, Ds, Ds, Wwf, Ds^Ewsh, Wwf, Ww^Ewl, Wwr, Wwf, Ww^Ewl, Wwf, Wwf, Wwf, Wwf, Wwf
Gs, Gs, Ce, Ce, 1 Ke, Ce, Gs, Gs, Ds, Ds, Ds, Ds, Ds, Ds, Wwf, Ds, Ds, Gs, Ds, Ds, Ds, Ds, Wwf, Wwf, Wwf, Ds, Ds, Rrc, Ds, Ds, Wwf, Wwf, Wwf, Wwf, Wwf, Wwf, Ww, Wwf, Wwf, Wwf, Wwf, Wwf, Wwf, Wwf, Wwf, Wwf
Gs, Gs, Wwf, Ce, Ce, Ce, Ds, Ds, Ds, Ds, Ds, Ds, Wwf, Wwf, Ds^Ewsh, Ds, Ds, Ds, Wwf, Wwf, Wwf, Ds, Wwf, Wwf, Wwf, Ds, Wwf, Rr^Vd, Wwf, Wwf, Wwf, Wwf, Wwf, Wwf, Wwf, Ww, Wwf, Wwf, Gs, Gs, Gs, Gs, Gs, Gs, Gs, Gs
Wwf, Wwf, Wwf, Wwf, Wwf, Rr^Vd, Wwg, Ds, Wwg, Ds, Wwf, Wwf, Wwf, Wwf, Ds, Ds, Ds, Wwf, Wwf, Wwf, Gs, Wwf, Wwr, Wwf, Wwg, Wwf, Wwg, Wwg, Wwg, Wwf, Wwg, Wwf, Wwg, Wwf, Wwg, Wwf, Wwg, Gs, Wwg, Gs, Wwg, Gs, Wwg, Gs, Wwg, Gs
Wo, Wwf, Wwf, Wwf, Wwg, Wwg, Wwg, Wwg, Wwg, Wwg, Wwg, Wwf, Wwg, Wwg, Wwg, Wwg, Wwg, Wwg^Bw\, Wwg^Bw|, Wwg, Wwg, Wwf, Wwg, Wwg, Wwg, Wwg, Wwg, Wwg, Wwg, Wwg, Wwg, Wwg, Wwg, Wwg, Wwg, Wwg, Wwg, Wwg, Wwg, Wwg, Wwg, Wwg, Wwg, Wwg, Wwg, Wwg
Wwg, Wwg, Wwg, Wwg, Wwg, Wwg, Ww^Ewl, Wwg, Wwg, Wwg, Wwg, Wwg, Wwg, Ww^Ewl, Wwg, Wwg, Wwg, Wwg, Wwg^Bw|, Wwg, Wwg, Wwg, Wwg, Wwg, Wwg, Wwg, Wwg, Wwg, Wwg, Wwg, Wwg, Wwg, Wwg, Wwr, Wwg, Wwg, Wwg, Ww^Ewl, Wwg, Wwg, Ww^Ewl, Wwg, Wwg, Wwg, Wwg, Wwg
Wwg, Wwg, Wwg, Wwr, Wwg, Wwg, Wwg, Wwg, Wwg, Wwg, Wwg, Wwg, Wwg, Wwg, Wwg, Wwg, Wwg, Wwg, Wwg^Bw|, Wwg, Wwg, Wwr, Wwg, Wwg, Wwg, Wwg, Wwg, Wwg, Wwg, Wwg, Wwg, Wwg, Wwg, Wwg, Wwg, Ww^Vm, Wwg, Wwg, Wo, Wwg, Wwg, Wwg, Wwg, Wwr, Wwg, Wwg
Wo, Wwg, Wo, Wwg, Wo, Wwg, Wo, Wwg, Wwg, Wwg, Wo, Wwg, Wo, Wwg, Wo, Wwg, Wo, Gs, Rr^Vd, Wwg, Wo, Wwg, Wo, Wwg, Wo, Wwg, Wo, Ww^Vm, Wo, Wwg, Wo, Wwg, Wwg, Wwg, Wo, Wwg, Wo, Wo, Wo, Wwg, Wo, Wwg, Ww^Vm, Wwg, Wwg, Wwg
Wo, Wo, Wo, Wo, Wo, Wo, Wo, Wo, Wo, Wo, Wo, Wo, Wo, Wo, Wo, Wo, Wo, Gs^_mh, Gs^_mh, Wo, Wo, Wo, Wo, Wo, Wo, Wo, Wo, Wo, Wo, Wo, Wo, Wot, Wo, Wo, Wo, Wo, Wo, Wo, Wo, Cm, 3 Km, Wo, Wo, Wo, Wo, Wo
Wo, Wo, Wo, Wo, Wo, Wo, Wo, Wo, Cme, Wo, Wo, Wo, Wo, Wo, Wwr, Wo, Wo, Wo, Wo, Wo, Wo, Wo, Wo, Wo, Wo, Wo, Wo, Wo, Wo, Wo, Wo, Rr^Vd, Wo, Wo, Wo, Wo, Wo, Wo, Wo, Cm, Wo, Wo, Wo, Wo, Wo, Wo
Wo, Wo, Wo, Wo, Wo, Ww^Vm, Wo, Wo, 4 Kme, Cme, Wo, Wo, Wo, Wo, Wo, Wo, Wo, Wo, Wo, Wo, Wo, Wo, Wo, Wo, Wo, Wo, Wo, Wo, Wo, Wo, Wo, Wo, Wo, Wo, Wo, Wo, Wo, Wo, Wo, Wo, Wo, Wo, Wo, Wo, Wo, Wo
Wo, Wo, Wo, Wo, Wo, Wo, Wo, Wo, Wo, Wo, Wo, Wo, Wo, Wo, Wo, Wo, Wo, Wo, Wo, Wo, Wo, Wo, Wo, Wo, Wo, Wo, Wo, Wo, Wo, Wo, Wo, Wo, Wo, Wo, Wo, Wo, Wo, Wo, Wo, Wo, Wo, Wo, Wo, Wo, Wo, Wo
