Mm^Qhh, Mm^Qhh, Mm^Qhh, Mm^Qhh, Mm^Qhh, Mm^Qhh, Ha^Qhh, Mm^Qhh, Mm^Qhh, Mm^Qhh, Mm^Qhh, Mm^Qhh, Mm^Qhh, Mm^Qhh, Mm^Qhh, Mm^Qhh, Mm^Qhh, Mm^Qhh, Mm^Qhh, Aa^Qhh, Ha^Qhh, Mm^Qhh, Mm^Qhh, Mm^Qhh, Mm^Qhh, Mm^Qhh, Mm^Qhh, Mm^Qhh, Ha^Qhh, Mm^Qhh, Mm^Qhh, Mm^Qhh, Mm^Qhh, Mm^Qhh, Mm^Qhh, Mm^Qhh, Mm^Qhh, Mm^Qhh, Mm^Qhh, Mm^Qhh, Mm^Qhh, Mm^Qhh, Mm^_mhh, Mm^Qhh, Mm^Xm, Mm^Xm, Mm^Xm, Mm^Xm, Mm^Xm, Mm^Qhh, Mm^Xm, Mm^Qhh, Mm^Qhh, Mm^Qhh, Wog^Qhu, Wog^Qhu, Wog^Qhu
Mm^Qhh, Mm^Xm, Mm^Xm, Mm^Xm, Mm^Xm, Mm^Xm, Ha^_mhh, Mm^Xm, Mm^Xm, Mm^Xm, Mm, Mm^Xm, Mm^Xm, Mm^Xm, Mm^Xm, Mm^Xm, Mm^Xm, Mm^Xm, Mm^Xm, Ha^Fpa, Ha^_mhh, Mm^Xm, Mm^Xm, Mm^Xm, Mm^Xm, Mm^Xm, Mm^Xm, Mm^Xm, Ha, Mm^Xm, Mm, Mm^Xm, Mm^Qhh, Mm^Xm, Mm^Xm, Mm^_mhh, Mm^Qhh, Mm^Qhh, Mm^Qhh, Mm^Qhh, Mm^Qhh, Mm^Xm, Mm^Qhh, Mm^Xm, Mm^Qhh, Mm^Xm, Mm^Qhh, Mm^Qhh, Mm^Qhh, Mm^Xm, Mm^Qhh, Mm^Xm, Mm^Qhh, Mm^Qhh, Wog^Qhu, Wog, Wo^Qhu
Mm^Qhh, Mm^Xm, Mm^Xm, Ha^Fpa, Mm^Qhh, Mm^Xm, Mm, Mm^Xm, Ha^Fpa, Mm^Xm, Mm^Xm, Mm, Mm^Qhh, Mm^Qhh, Mm^Qhh, Mm^Qhh, Mm^Qhh, Mm^Qhh, Mm^Qhh, Mm^Xm, Mm, Mm^Xm, Ha^Fpa, Mm^Xm, Mm, Ha^Fpa, Mm^Xm, Mm, Mm^Xm, Ha^Fpa, Mm^Qhh, Mm^Qhh, Ww, Mm^Qhh, Mm^Qhh, Mm^Qhh, Ww, Ww, Ww, Ww, Ww, Mm^Qhh, Ww, Mm^Qhh, Wot^Qov, Mm^Qhh, Wot, Wot, Wot, Hh^Qhh, Wog^Qhu, Mm^Qhh, Wog^Qhu, Wog^Qhu, Wog, Wog, Wo^Qhu
Mm^Qhh, Mm^Qhh, Hh^Qhh, Mm^Qhh, Wwf, Mm^Qhh, Hh^Qhh, Mm^Qhh, Mm^Qhh, Mm^Xm, Mm^Qhh, Mm^Qhh, Wwf, Ww, Ww, Ww, Cme, 2 Kme, Ww, Mm^Qhh, Mm^Qhh, Mm^Qhh, Mm^Qhh, Mm^Xm, Mm^Qhh, Mm^Xm, Mm^Qhh, Mm^Xm, Mm^Qhh, Mm^Qhh, Ww, Ww, Ww, Ww, Ww, Ww, Wwf, Wwf, Mm, Mm, Mm, Ww, Ww, Ww^Qhh, Ww^Qhh, Wot^Qov, Wot^Qov, Wot, Wot, Wot^Qov, Wot^Qov, Wog^Qhu, Wog, Wog, Wog, Wog, Wo^Qhu
Ww, Wwf, Wwf, Wwf, Ww, Ww, Ww, Wwf, Ww, Mm^Qhh, Wwf, Wwf, Wo, Wwf, Wo, Ww, Ww, Cme, Ww, Ww^Ewf, Ww, Ww, Ww, Mm^Qhh, Wwf, Mm^Qhh, Wwf, Mm^Qhh, Ww, Ww, Ww, Ww, Mm, Ww, Ww, Ww, Ww, Hh, Mm, Mm^Vd, Mm, Wwf, Ww, Ww, Ww, Ww^Qhh, Wot^Qov, Wot, Wot, Wot, Wot^Qov, Wog^Qhu, Wog, Wog^_ml, Wog, Wog, Wog^Qhu
Ww, Ww, Ww, Ww, Ww, Ww, Ww, Ww, Ww, Ww, Ww, Ww, Ww, Wo, Ww, Ww, Mm, Ww, Ww, Ww, Ww, Ww, Ww, Ww, Ww, Ww, Ww, Ww, Ww, Ww, Mm, Mm^Vd, Mm, Ww, Ww, Ww, Ww, Ww, Ww, Mm, Hh, Ww, Ww^Qhh, Ww^Qhh, Mm^Vd, Ww^Qhh, Ww^Qhh, Wot^Qov, Wot^Qov, Wot, Wot^Qov, Wog^Qhu, Wog^Qhu, Wog^Qhu, Wog^Qhu, Wog^Qhu, Wog^Qhu
Ww, Ww, Ww, Ww, Ww, Wwf^Vm, Wwf, Ww, Wwf, Wwf, Wwf, Ww, Ww, Ww, Ww, Mm, Mm^Vd, Mm, Gs^Fp, Ww, Ww, Ww, Hh, Ww, Ww, Ww, Ww, Ww^Vm, Ww, Wwf, Hh, Mm, Ww, Ww, Ww, Ww, Ww, Ww, Wwf, Ww, Ww, Ww, Ww^Qhh, Mm, Ww, Ww, Wo^_mh, Ww^Qhh, Wot^Qov, Wot, Wot, Wot^Qov, Mm, Mm, Mm, Mm, Mm
Gs^Fp, Ww, Rd, Wwf, Ww, Wwf, Ww, Ww, Ww, Wwf, Ww, Wwf^Vm, Ww, Ww, Wwf, Mm, Mm, Hh, Hh, Ww, Ww, Wwf, Mm^Vd, Mm, Wwf, Wwf, Ww, Ww, Ww^Ewf, Ww, Ww, Ww, Ww, Ww, Ww, Ww, Ww, Wwf, Mm, Ww, Ww, Ww, Ww, Ww^Qhh, Ww, Ww, Ww^Qhh, Ww^Qhh, Mm^Xm, Wot, Mm^Xm, Mm, Mm, Ha^Fpa, Mm, Mm, Mm
Gs, Ce, Ce, Gs^Fp, Mm, Ww, Wwf, Ww, Wwf, Ww, Ww, Ww, Ww, Ww, Ww, Wwf, Wwf, Wwf, Wwf, Ww, Ww, Ww, Mm, Mm, Ww, Ww, Ww, Ww, Mm, Ww, Ww, Ww, Wo, Wo, Wo, Ww, Ww, Mm, Mm^Vd, Mm, Ww, Ww, Wo, Ww^Qhh, Ww^Qhh, Ww^Qhh, Mm, Mm, Mm, Mm^Xm, Mm^Xm, Ai, Mm^Xm, Mm, Ha^Fpa, Mm, Mm
Mm, Ce, Mm, Mm, Mm^Xm, Mm^Xm, Mm, Wwf, Wwf, Wwf, Ww, Ww, Mm, Wwf, Wwf, Ww, Ww, Ww, Ww, Ww, Ww, Ww, Wwf, Ww, Ww, Ww, Wwf, Mm, Mm^Vd, Mm, Wwf, Ww, Ww, Wo, Ww, Ww, Ww, Mm, Mm, Mm, Ww, Ww, Ww, Ww, Wwf, Hh, Mm, Mm, Ha, Ha^Fpa, Mm^Xm, Mm^Xm, Mm^Xm, Mm^Xm, Ha, Mm^Xm, Mm^Xm
Mm, Ce, Mm, Mm^Xm, Mm, Mm, Mm, Wwf, Ww, Ww, Ww, Mm, Mm^Vd, Mm, Wwf, Ww, Ww, Ww, Wo, Ww, Ww, Ww, Ww, Ww, Ww, Ww, Ww, Mm, Mm, Wwf, Ww, Ww, Ww, Ww, Ww, Ww, Ww, Ww, Ww, Wwf, Ww, Ww, Ww, Ww, Ww, Mm, Mm, Mm, Mm^Xm, Mm^Xm, Mm^Xm, Ha, Mm^Xm, Mm^Xm, Mm^Xm, Mm^Xm, Mm^Xm
Gs, 1 Ke, Ce, Ce, Wwf, Ww, Ww, Ww, Ww, Ww, Ww, Mm, Mm, Gs^Fp, Wwf, Ww, Ww, Ww, Ww, Ww, Ww, Ww, Wwrg, Ww, Wwf, Ww, Ww, Ww, Ww, Wwf, Ww, Ww, Ww, Ww, Mm, Ww, Ww, Ww^Vm, Ww, Ww, Hh, Mm, Mm, Ww, Ww, Ww^Ewf, Ww, Mm, Ww, Mm^Xm, Ha, Mm^Xm, Mm^Xm, Ha^Fpa, Mm^Xm, Mm^Xm, Mm^Xm
Wwf, Ce, Wwf, Wwf, Ww, Ww, Wwf, Gg, Ww, Wwf, Wwf, Mm, Hh, Wwf, Ww, Wwf, Ww, Ww, Ww^Vm, Ww, Wwf, Ww, Hh, Mm, Mm, Wwf, Ww, Ww, Ww, Ww, Ww, Ww, Wwf, Mm, Mm, Hh, Wwf, Ww, Ww, Wwf, Gs^Fp, Mm^Vd, Cte, Ww, Ww, Ww, Ww, Ww, Hh, Ww, Ww, Mm^Xm, Mm, Mm, Mm, Mm^Xm, Mm^Xm
Ww, Ww, Ww, Ww, Ww^Vm, Ww, Ww, Gs^Fp, Ww, Ww, Ww, Ww, Ww, Ww, Ww, Ww, Ww, Ww, Ww, Ww, Ww, Wwf, Hh, Mm^Vd, Mm, Mm, Ww, Ww, Ww, Wo, Ww, Ww, Ww, Mm, Wwf, Wwf, Ww, Ww, Ww, Ww, Wwf, Cte, 3 Ko, Ww, Ww, Ww, Ww, Mm, Mm^Vd, Ww, Ww, Hh, Hh, Mm, Mm, Mm^Xm, Mm^Xm
Ww, Ww, Ww, Ww, Ww, Ww, Ww, Ww, Ww, Ww^Vm, Ww, Ww, Ww, Ww, Ww, Ww, Wwf, Ww, Ww, Ww, Ww, Ww, Ww, Mm, Ww, Ww, Ww, Ww^Vm, Ww, Wo, Ww^Vm, Ww, Ww, Ww, Hh, Mm, Ww, Ww, Ww, Ww, Ww, Wwf, Wwf, Ww, Wwf, Ww, Ww, Wwf, Wwf, Ww, Ww, Mm, Mm, Mm^Xm, Mm^Xm, Mm^Xm, Mm^Xm
Ww, Ww, Ww, Ww, Ww, Ww, Ww, Ww, Ww, Ww, Ww, Ww, Mm, Ww^Ewf, Mm, Mm, Mm, Mm, Mm, Ww, Ww, Ww, Ww, Ww, Ww, Ww, Ww, Ww, Ww, Ww, Ww, Ww, Ww, Ww, Ww, Wwf, Wwf, Ww, Ww, Ww, Ww, Ww, Wwf, Wwf, Mm, Hh, Mm, Wwf, Hh, Wwf, Mm^Xm, Mm^Xm, Hh, Mm^Xm, Mm, Mm, Mm
Ww, Ww, Mm, Ww, Mm, Ww, Wwf, Ww, Mm, Ww, Mm, Mm, Mm, Mm, Mm^Xm, Mm, Mm, Mm, Mm^Xm, Mm^Xm, Mm, Hh, Mm, Ww, Mm, Ww, Mm, Ww, Mm, Ww, Ww, Ww, Ww, Ww, Ww, Wwf, Mm, Hh, Wwf, Ww, Ww^Vm, Ww, Ww, Wwf, Hh, Mm, Mm, Mm, Mm, Mm, Mm^Xm, Mm, Mm^Xm, Mm^Xm, Mm^Xm, Mm^Xm, Mm
Mm, Mm, Mm^Xm, Mm, Hh^Fp, Wwf, Mm^Xm, Hh, Hh, Mm, Mm^Xm, Mm, Hh, Hh^Fp, Mm^Xm, Mm, Hh, Hh, Mm^Xm, Mm^Xm, Mm^Xm, Mm^Xm, Mm, Mm, Mm^Xm, Mm, Mm^Xm, Wwf, Mm, Mm, Ww, Ww, Ww, Ww^Ewf, Mm, Mm, Mm, Mm, Hh, Ww, Ww, Ww, Ww, Hh^Fp, Mm, Mm, Mm, Mm, Mm, Mm^Xm, Mm^Xm, Mm^Xm, Hh, Mm^Xm, Mm^Xm, Hh, Mm
Mm, Mm^Xm, Mm^Xm, Mm^Xm, Mm^Xm, Mm^Xm, Mm^Xm, Mm^Xm, Hh, Mm^Xm, Mm^Xm, Hh^Fp, Mm^Xm, Mm^Xm, Mm^Xm, Mm^Xm, Mm^Xm, Hh, Mm^Xm, Mm^Xm, Mm, Mm, Mm, Mm^Xm, Mm^Xm, Mm^Xm, Mm^Xm, Mm^Xm, Mm^Xm, Mm^Xm, Mm, Ww, Ww, Ww, Ww, Mm, Mm, Mm, Wo, Wo, Ww, Ww, Ww, Gs^Fp, Hh, Mm, Mm, Hh, Mm^Xm, Mm^Xm, Mm^Xm, Mm^Xm, Mm^Xm, Mm^Xm, Mm^Xm, Mm^Xm, Mm
Mm^Xm, Mm^Xm, Mm^Xm, Mm^Xm, Mm^Xm, Mm^Xm, Hh^Fp, Mm^Xm, Mm^Xm, Mm, Mm, Mm^Xm, Hh^Fp, Mm^Xm, Mm^Xm, Mm^Xm, Mm^Xm, Mm^Xm, Mm^Xm, Mm^Xm, Mm^Xm, Mm^Xm, Hh^Fp, Mm^Xm, Hh, Mm^Xm, Mm^Xm, Mm^Xm, Hh, Mm^Xm, Mm^Xm, Ww, Ww, Ww, Ww, Ww^Vm, Ww, Ww, Ww, Ww, Ww, Ww, Gs^Fp, Gs, Gs^Fp, Mm, Mm^Xm, Mm, Mm^Xm, Hh, Mm^Xm, Mm^Xm, Mm^Xm, Mm^Xm, Mm^Xm, Mm^Xm, Mm^Xm
Mm^Xm, Hh, Mm^Xm, Mm^Xm, Hh, Mm, Mm, Mm^Xm, Hh^Qhux, Hh^Qhux, Ms^Qhux, Hh^Qhux, Hh^Qhux, Ha^Qhux, Mm^Qhux, Mm^Xm, Hh^Qhux, Mm^Xm, Mm^Xm, Mm^Xm, Mm^Xm, Mm^Xm, Mm^Xm, Mm^Xm, Mm, Mm^Xm, Mm^Xm, Mm^Xm, Mm^Xm, Mm^Xm, Mm^Xm, Mm, Mm, Ww, Ww, Ww, Ww, Ww, Hh, Ww, Wwf, Wwf, Hh, Hh, Gs^Fp, Mm^Xm, Mm, Mm, Mm^Xm, Mm^Xm, Mm^Xm, Mm^Xm, Mm^Xm, Mm^Xm, Mm^Xm, Mm^Xm, Mm
Mm^Xm, Hh^Fp, Mm^Xm, Mm^Xm, Hh^Qhux, Hh, Ms^Qhux, Hh^Qhux, Mm, Mm^Xm, Mm^Xm, Mm, Ms^Xm, Ms^Xm, Ms^Xm, Mm^Qhux, Ms^Xm, Ha^Qhux, Ha^Qhux, Hh^Qhux, Hh^Qhux, Mm^Xm, Hh^Qhux, Mm, Mm^Qhux, Mm, Hh^Qhux, Mm^Xm, Mm^Xm, Hh^Fp, Mm^Xm, Mm^Xm, Mm^Xm, Mm, Mm, Ww, Mm, Hh, Mm, Hh, Hh^Fp, Hh, Hh^Fp, Gs, Mm, Mm^Xm, Mm, Mm^Xm, Mm^Xm, Hh, Mm^Xm, Mm^Xm, Mm^Xm, Mm^Xm, Mm, Mm^Xm, Ms^Xm
Ms^Qhux, Hh^Qhux, Gs^Qhux, Gs^Qhux, Ms^Xm, Ms, Ms^Xm, Ms^Xm, Ms, Mm^Xm, Mm^Xm, Mm^Xm, Mm^Xm, Ms^Xm, Mm, Ms^Xm, Mm, Ms^Xm, Mm^Xm, Mm^_ml, Hh^Qhux, Hh^Qhux, Mm^Xm, Mm^Qhux, Mm^Xm, Hh^Qhux, Mm^_ml, Hh^Qhux, Ha^Qhux, Mm^Xm, Hh^Qhux, Mm^Xm, Mm^Xm, Mm, Mm, Mm, Mm^Xm, Hh, Mm^Xm, Mm^Xm, Mm^Xm, Mm^Xm, Mm^Xm, Mm^Xm, Ms^Xm, Mm, Mm^Xm, Mm^Xm, Mm^Xm, Mm^Xm, Mm, Mm^Xm, Mm, Mm, Hh, Hh^Fp, Ms^Xm
Gs^Fp, Ms^Qhux, Ms^Xm, Ms, Ms, Ms^Xm, Mm, Ms^Xm, Gs^Fp, Mm, Gs^Fp, Mm, Mm, Mm^Xm, Ms, Mm, Mm, Mm, Hh^Qhux, Hh^Qhux, Mm, Mm^Xm, Hh^Qhux, Mm^Xm, Mm^Qhux, Mm^Xm, Mm^Qhux, Mm^Qhux, Mm, Ha^Qhux, Mm^_ml, Mm^Qhux, Mm, Mm^Xm, Mm, Mm, Mm, Mm^Xm, Mm^Xm, Mm^Xm, Mm^Xm, Mm^Xm, Mm^Xm, Mm^Xm, Ms^Xm, Ms^Xm, Ms^Xm, Ms^Xm, Ms^Xm, Ms^Xm, Ms^Xm, Ms^Xm, Ms^Xm, Ms^Xm, Ms^Xm, Ms^Xm, Hh^Fp
